És de dia. Al passeig d'una platja, una parella passeja un gos i un noi fa footing. El gos s'atura per ensumar el terra, i de seguida torna amb el seu amo, que es gira a rebre'l.	ST-CA/Altadill_Judit_CA/Altadill_Judit_CA.eaf
A la carretera de davant del passeig, un bmw blanc s'atura.	ST-CA/Altadill_Judit_CA/Altadill_Judit_CA.eaf
És un home d'uns 40 anys, de cabells castanys i amb barba. Duu americana, corbata i un maletí.	ST-CA/Altadill_Judit_CA/Altadill_Judit_CA.eaf
Es posa unes ulleres de sol. Es posa les mans a les butxaques i sospira.	ST-CA/Altadill_Judit_CA/Altadill_Judit_CA.eaf
És en James, l'empresari. Camina amb una bossa de platja penjada a l'espatlla. Es posa el telèfon a l'orella.	ST-CA/Altadill_Judit_CA/Altadill_Judit_CA.eaf
A la sorra, s'estira sobre una tovallola.	ST-CA/Altadill_Judit_CA/Altadill_Judit_CA.eaf
Es frega els ulls i deixa caure els braços.	ST-CA/Altadill_Judit_CA/Altadill_Judit_CA.eaf
Mira al seu voltant, neguitós.	ST-CA/Altadill_Judit_CA/Altadill_Judit_CA.eaf
S'aixeca. S'acosta a la vora del mar, posa els peus a l'aigua, i torna enrere, mirant al seu voltant.	ST-CA/Altadill_Judit_CA/Altadill_Judit_CA.eaf
S'atura, es queda mirant enlaire i torna cap a la vora.	ST-CA/Altadill_Judit_CA/Altadill_Judit_CA.eaf
Torna a mirar enrere, mira cap a la seva dreta, i torna a acostar-se a l'aigua. Mira al seu voltant, estranyat, es gira i camina cap a la tovallola.	ST-CA/Altadill_Judit_CA/Altadill_Judit_CA.eaf
Agafa la camisa i se la posa, sense deixar de mirar a totes bandes.	ST-CA/Altadill_Judit_CA/Altadill_Judit_CA.eaf
En James, ara tot vestit, camina per un passeig entre arbres.	ST-CA/Altadill_Judit_CA/Altadill_Judit_CA.eaf
Puja per un camí d'una muntanya.	ST-CA/Altadill_Judit_CA/Altadill_Judit_CA.eaf
Un home d'uns 60 anys, amb barba i cabells blancs i despentinats, mira el no res.	ST-CA/Altadill_Judit_CA/Altadill_Judit_CA.eaf
Fa que no amb el cap i abaixa la mirada.	ST-CA/Altadill_Judit_CA/Altadill_Judit_CA.eaf
Fa una rodona amb el dit a la tapa d'un got de cafè per emportar, l'obre, es mira l'interior i beu.	ST-CA/Altadill_Judit_CA/Altadill_Judit_CA.eaf
És en Rick, el jubilat.	ST-CA/Altadill_Judit_CA/Altadill_Judit_CA.eaf
Està assegut al banc d'un parc, entre arbres, duu una samarreta de tirants i té un aspecte deixat. Continua bevent el cafè i mou la cama dreta, nerviós. Deixa el cafè sobre el banc.	ST-CA/Altadill_Judit_CA/Altadill_Judit_CA.eaf
Es treu un mòbil de la butxaca, busca entre els contactes i truca algú.	ST-CA/Altadill_Judit_CA/Altadill_Judit_CA.eaf
Mira enlaire.	ST-CA/Altadill_Judit_CA/Altadill_Judit_CA.eaf
S'aixeca i s'allunya del banc. Es gira i camina d'esquenes, mirant el banc i enlaire.	ST-CA/Altadill_Judit_CA/Altadill_Judit_CA.eaf
Una noia d'uns 20 anys, de cabells arrissats i pèl-rojos, està asseguda davant un ordinador, pensativa.	ST-CA/Altadill_Judit_CA/Altadill_Judit_CA.eaf
És la Jess, l'estudiant.	ST-CA/Altadill_Judit_CA/Altadill_Judit_CA.eaf
Busca el mòbil.	ST-CA/Altadill_Judit_CA/Altadill_Judit_CA.eaf
Mira al seu voltant, incòmoda.	ST-CA/Altadill_Judit_CA/Altadill_Judit_CA.eaf
Al carrer, amb la jaqueta posada, la Jess continua mirant a tots cantons, estranyada.	ST-CA/Altadill_Judit_CA/Altadill_Judit_CA.eaf
S'endinsa entre uns matolls. S'atura, mira enrere i s'allunya corrents.	ST-CA/Altadill_Judit_CA/Altadill_Judit_CA.eaf
En una esplanada enmig d'una muntanya, es troben tots tres.	ST-CA/Altadill_Judit_CA/Altadill_Judit_CA.eaf
Palplantats, formen un triangle. No deixen de mirar enlaire i al seu voltant, desconcertats.	ST-CA/Altadill_Judit_CA/Altadill_Judit_CA.eaf
Amb la mà al cap.	ST-CA/Altadill_Judit_CA/Altadill_Judit_CA.eaf
Fa el moviment amb el dit.	ST-CA/Altadill_Judit_CA/Altadill_Judit_CA.eaf
En Rick i la Jess fan que no amb el cap.	ST-CA/Altadill_Judit_CA/Altadill_Judit_CA.eaf
En Rick alça els braços, alleujat.	ST-CA/Altadill_Judit_CA/Altadill_Judit_CA.eaf
La Jess mira avall, incrèdula.	ST-CA/Altadill_Judit_CA/Altadill_Judit_CA.eaf
Tots tres s'allunyen.	ST-CA/Altadill_Judit_CA/Altadill_Judit_CA.eaf
No, encara no l'he estesa tota. M'he d'afanyar a acabar.	ST-CA/Altadill_Judit_CA/Altadill_Judit_CA.eaf
No, però de què em parles? Si, esclar, ja he fet les maletes...	ST-CA/Altadill_Judit_CA/Altadill_Judit_CA.eaf
Mira al seu voltant.	ST-CA/Altadill_Judit_CA/Altadill_Judit_CA.eaf
Escolta, ara no puc parlar. T'he de deixar.	ST-CA/Altadill_Judit_CA/Altadill_Judit_CA.eaf
Mira al seu voltant, sorpresa. És la Zoé, la següent.	ST-CA/Altadill_Judit_CA/Altadill_Judit_CA.eaf
Sobre un fons blanc, en lletres negres: què passa mentre, seguit d'una ratlla.	ST-CA/Altadill_Judit_CA/Altadill_Judit_CA.eaf
En un dia una mica ennuvolat, a la platja, un noi i una noia passegen un gos i un noi corre.	ST-CA/Arderius_Elvira_CA/Arderius_Elvira_CA.eaf
El gos s'atura a ensumar el terra. El noi i la noia es creuen amb el corredor.	ST-CA/Arderius_Elvira_CA/Arderius_Elvira_CA.eaf
Sobre un fons blanc, amb lletres negres:	ST-CA/Arderius_Elvira_CA/Arderius_Elvira_CA.eaf
Un cotxe platejat de dues portes aparca al carrer de davant la platja.	ST-CA/Arderius_Elvira_CA/Arderius_Elvira_CA.eaf
El conductor, en James, parla per telèfon i baixa del cotxe amb un maletí.	ST-CA/Arderius_Elvira_CA/Arderius_Elvira_CA.eaf
Desa el maletí al maleter.	ST-CA/Arderius_Elvira_CA/Arderius_Elvira_CA.eaf
En treu una bossa de ratlles.	ST-CA/Arderius_Elvira_CA/Arderius_Elvira_CA.eaf
En James, d'uns quaranta anys, duu barba, corbata, camisa clara i vestit negre.	ST-CA/Arderius_Elvira_CA/Arderius_Elvira_CA.eaf
Es treu unes ulleres de sol d'una butxaca de la jaqueta i se les posa.	ST-CA/Arderius_Elvira_CA/Arderius_Elvira_CA.eaf
Amb lletres blanques: James, l'empresari.	ST-CA/Arderius_Elvira_CA/Arderius_Elvira_CA.eaf
En James camina amb la bossa de ratlles penjada mentre parla per telèfon.	ST-CA/Arderius_Elvira_CA/Arderius_Elvira_CA.eaf
Sobre la sorra de la platja hi ha una tovallola estesa i el vestit d'en James.	ST-CA/Arderius_Elvira_CA/Arderius_Elvira_CA.eaf
En James s'hi estira. Va amb banyador.	ST-CA/Arderius_Elvira_CA/Arderius_Elvira_CA.eaf
Es frega els ulls i deixa caure els braços sobre la sorra.	ST-CA/Arderius_Elvira_CA/Arderius_Elvira_CA.eaf
Juga amb la sorra amb els dits.	ST-CA/Arderius_Elvira_CA/Arderius_Elvira_CA.eaf
Estranyat, en James mira al seu voltant.	ST-CA/Arderius_Elvira_CA/Arderius_Elvira_CA.eaf
S'aixeca i camina cap al mar, però torna enrere.	ST-CA/Arderius_Elvira_CA/Arderius_Elvira_CA.eaf
Desconcertat, es torna a apropar a l'aigua.	ST-CA/Arderius_Elvira_CA/Arderius_Elvira_CA.eaf
Finalment torna cap a la tovallola i es posa la camisa. Continua desconcertat i escruta el seu voltant amb la mirada.	ST-CA/Arderius_Elvira_CA/Arderius_Elvira_CA.eaf
En James, amb la camisa i el vestit fosc, camina per un passeig amb arbres a banda i banda.	ST-CA/Arderius_Elvira_CA/Arderius_Elvira_CA.eaf
Puja per un camí escarpat envoltat de matolls.	ST-CA/Arderius_Elvira_CA/Arderius_Elvira_CA.eaf
En un parc, en Rick aguanta un got de cafè.	ST-CA/Arderius_Elvira_CA/Arderius_Elvira_CA.eaf
Té uns seixanta-cinc anys, va despentinat i porta barba i samarreta de tirants. Té un aspecte descuidat.	ST-CA/Arderius_Elvira_CA/Arderius_Elvira_CA.eaf
Treu la tapa del got i en fa un glop.	ST-CA/Arderius_Elvira_CA/Arderius_Elvira_CA.eaf
Amb lletres blanques: Rick, el jubilat.	ST-CA/Arderius_Elvira_CA/Arderius_Elvira_CA.eaf
Deixa la tapa en una altra cadira i continua bevent.	ST-CA/Arderius_Elvira_CA/Arderius_Elvira_CA.eaf
Té un tic nerviós a la cama dreta.	ST-CA/Arderius_Elvira_CA/Arderius_Elvira_CA.eaf
En Rick es treu un mòbil de la butxaca del darrere dels pantalons.	ST-CA/Arderius_Elvira_CA/Arderius_Elvira_CA.eaf
Selecciona un contacte de la llista i li truca.	ST-CA/Arderius_Elvira_CA/Arderius_Elvira_CA.eaf
Estranyat, mira al seu voltant.	ST-CA/Arderius_Elvira_CA/Arderius_Elvira_CA.eaf
Alça la vista.	ST-CA/Arderius_Elvira_CA/Arderius_Elvira_CA.eaf
Deixa el cafè a la cadira. Se'n va caminant mentre no deixa de mirar al seu voltant.	ST-CA/Arderius_Elvira_CA/Arderius_Elvira_CA.eaf
En un estudi hi ha la Jess, d'uns divuit anys.	ST-CA/Arderius_Elvira_CA/Arderius_Elvira_CA.eaf
Amb lletres blanques: Jess, l'estudiant.	ST-CA/Arderius_Elvira_CA/Arderius_Elvira_CA.eaf
La Jess busca el mòbil entre el portàtil i els apunts.	ST-CA/Arderius_Elvira_CA/Arderius_Elvira_CA.eaf
La Jess mira confusa al seu voltant.	ST-CA/Arderius_Elvira_CA/Arderius_Elvira_CA.eaf
S'aixeca de la cadira.	ST-CA/Arderius_Elvira_CA/Arderius_Elvira_CA.eaf
Amb l'abric posat, la Jess surt al carrer. Té els cabells llargs, arrissats i vermellosos.	ST-CA/Arderius_Elvira_CA/Arderius_Elvira_CA.eaf
Puja per un camí ple d'herbes i envoltat d'arbres i de canyes mentre continua buscant al seu voltant.	ST-CA/Arderius_Elvira_CA/Arderius_Elvira_CA.eaf
Finalment arriba a un descampat. Fa un dia radiant. Hi ha dos homes més, en James i en Rick.	ST-CA/Arderius_Elvira_CA/Arderius_Elvira_CA.eaf
Tots tres estan desconcertats.	ST-CA/Arderius_Elvira_CA/Arderius_Elvira_CA.eaf
Miren cap al cel i cap als arbres que envolten el descampat.	ST-CA/Arderius_Elvira_CA/Arderius_Elvira_CA.eaf
En James mira cap amunt.	ST-CA/Arderius_Elvira_CA/Arderius_Elvira_CA.eaf
En Rick fa que no amb el cap i s'arronsa d'espatlles.	ST-CA/Arderius_Elvira_CA/Arderius_Elvira_CA.eaf
En Rick segueix en James.	ST-CA/Arderius_Elvira_CA/Arderius_Elvira_CA.eaf
La Jess alça les celles i somriu.	ST-CA/Arderius_Elvira_CA/Arderius_Elvira_CA.eaf
Els segueix.	ST-CA/Arderius_Elvira_CA/Arderius_Elvira_CA.eaf
Tots tres se'n van del descampat caminant lun al costat de laltre.	ST-CA/Arderius_Elvira_CA/Arderius_Elvira_CA.eaf
En un terrat, la Zoé, d'uns trenta anys, estén roba mentre parla per telèfon.	ST-CA/Arderius_Elvira_CA/Arderius_Elvira_CA.eaf
No, encara no l'he estès tota. M'he d'afanyar a acabar.	ST-CA/Arderius_Elvira_CA/Arderius_Elvira_CA.eaf
No, però de què em parles? Sí, esclar, ja he fet les maletes...	ST-CA/Arderius_Elvira_CA/Arderius_Elvira_CA.eaf
Escolta, ara no puc parlar. T'he de deixar.  	ST-CA/Arderius_Elvira_CA/Arderius_Elvira_CA.eaf
Amb lletres blanques: Zoé, la següent.	ST-CA/Arderius_Elvira_CA/Arderius_Elvira_CA.eaf
Amb lletres negres sobre un fons blanc: què passa mentre.	ST-CA/Arderius_Elvira_CA/Arderius_Elvira_CA.eaf
És de dia i el cel està lleugerament enuvolat. Pel passeig marítim d'una platja, dues persones avancen caminant d'esquerra a dreta. Van acompanyades d'un gos de raça gran que rastreja el terra.	ST-CA/Beneito_Satorres_CA/Beneito_Satorres_CA.eaf
En sentit contrari, passa una persona corrent.	ST-CA/Beneito_Satorres_CA/Beneito_Satorres_CA.eaf
Sobre fons blanc, imprès en anglès:	ST-CA/Beneito_Satorres_CA/Beneito_Satorres_CA.eaf
Al passeig. Un home d'uns 45 anys condueix un esportiu blanc mentre parla per telèfon. Va vestit amb americana i corbata. Estaciona el cotxe i obre el maleter.	ST-CA/Beneito_Satorres_CA/Beneito_Satorres_CA.eaf
Deixa un maletí i agafa una bossa.	ST-CA/Beneito_Satorres_CA/Beneito_Satorres_CA.eaf
L'home és ros amb els cabells curts i barba. S'amaga el mòvil a l'americana. Pensarós, treu d'una butxaca unes ulleres de sol i se les posa.	ST-CA/Beneito_Satorres_CA/Beneito_Satorres_CA.eaf
Imprès en pantalla: "James. L'empresari".	ST-CA/Beneito_Satorres_CA/Beneito_Satorres_CA.eaf
Camina amb la bossa al muscle i marca per telefonar.	ST-CA/Beneito_Satorres_CA/Beneito_Satorres_CA.eaf
A la sorra de la platja, el James amb vestit de bany s'ajeu sobre una tovallola estesa.	ST-CA/Beneito_Satorres_CA/Beneito_Satorres_CA.eaf
Es posa un moment les mans als ulls i les deixa caure sobre la sorra.	ST-CA/Beneito_Satorres_CA/Beneito_Satorres_CA.eaf
Desconcertat, mira al voltant.	ST-CA/Beneito_Satorres_CA/Beneito_Satorres_CA.eaf
S'aixeca i camina cap a la vora del mar.	ST-CA/Beneito_Satorres_CA/Beneito_Satorres_CA.eaf
Avança sense rumb clar i estranyat.	ST-CA/Beneito_Satorres_CA/Beneito_Satorres_CA.eaf
S'atura torbat i fa unes passes enrere.	ST-CA/Beneito_Satorres_CA/Beneito_Satorres_CA.eaf
Es gira una mica desorientat.	ST-CA/Beneito_Satorres_CA/Beneito_Satorres_CA.eaf
Avança de nou cap a la vora.	ST-CA/Beneito_Satorres_CA/Beneito_Satorres_CA.eaf
Però està indecís i fa mitja volta.	ST-CA/Beneito_Satorres_CA/Beneito_Satorres_CA.eaf
Camina mirant a totes bandes.	ST-CA/Beneito_Satorres_CA/Beneito_Satorres_CA.eaf
Va cap on havia deixat la roba i cavil·lós es posa la camisa.	ST-CA/Beneito_Satorres_CA/Beneito_Satorres_CA.eaf
Per un carrer amb arbres al costat, el James camina reflexiu.	ST-CA/Beneito_Satorres_CA/Beneito_Satorres_CA.eaf
Per una sendera envoltada de vegetació el James s'enfila cap amunt.	ST-CA/Beneito_Satorres_CA/Beneito_Satorres_CA.eaf
En un banc d'un parc hi ha assegut un home d'uns 65 anys amb un café a les mans.	ST-CA/Beneito_Satorres_CA/Beneito_Satorres_CA.eaf
Té barba, cabells canosos pel muscle i va vestit amb una samarreta de tirants.	ST-CA/Beneito_Satorres_CA/Beneito_Satorres_CA.eaf
Està absort pels pensaments.	ST-CA/Beneito_Satorres_CA/Beneito_Satorres_CA.eaf
Obre la tapa del got de café.	ST-CA/Beneito_Satorres_CA/Beneito_Satorres_CA.eaf
Hi rumia una mica i en pren un glop.	ST-CA/Beneito_Satorres_CA/Beneito_Satorres_CA.eaf
L'assaboreix mentre mira a l'infinit cavil·lós.	ST-CA/Beneito_Satorres_CA/Beneito_Satorres_CA.eaf
Imprès en pantalla: "Rick. El jubilat".	ST-CA/Beneito_Satorres_CA/Beneito_Satorres_CA.eaf
Deixa la tapa del got sobre un altre banc i pren el café mentre mou la cama neguitosament.	ST-CA/Beneito_Satorres_CA/Beneito_Satorres_CA.eaf
Deixa el got al banc i pica les mans nerviós.	ST-CA/Beneito_Satorres_CA/Beneito_Satorres_CA.eaf
Es treu de la butxaca el mòbil i cerca a l'agenda un número.	ST-CA/Beneito_Satorres_CA/Beneito_Satorres_CA.eaf
Mira cap amunt estranyat.	ST-CA/Beneito_Satorres_CA/Beneito_Satorres_CA.eaf
De nou, atordit.	ST-CA/Beneito_Satorres_CA/Beneito_Satorres_CA.eaf
S'aixeca del banc, guarda el mòbil a la butxaca i se'n va mentre mira amunt, enrere i als costats.	ST-CA/Beneito_Satorres_CA/Beneito_Satorres_CA.eaf
Davant d'un escriptori una noia d'uns 18 anys seu angoixada.	ST-CA/Beneito_Satorres_CA/Beneito_Satorres_CA.eaf
Imprès en pantalla: "Jess. L'estudiant".	ST-CA/Beneito_Satorres_CA/Beneito_Satorres_CA.eaf
És pèl-roja i amb els cabells arrissats.	ST-CA/Beneito_Satorres_CA/Beneito_Satorres_CA.eaf
Mou el cap amunt i als costats desconcertada.	ST-CA/Beneito_Satorres_CA/Beneito_Satorres_CA.eaf
S'aixeca i surt al carrer.	ST-CA/Beneito_Satorres_CA/Beneito_Satorres_CA.eaf
Camina esmaperduda i mirant al voltant.	ST-CA/Beneito_Satorres_CA/Beneito_Satorres_CA.eaf
S'endinsa per una sendera amb vegetació.	ST-CA/Beneito_Satorres_CA/Beneito_Satorres_CA.eaf
Avança amb pas dubitatiu i s'atura. Es gira, observa curiosa i accelera el pas.	ST-CA/Beneito_Satorres_CA/Beneito_Satorres_CA.eaf
Entre montanyes, al mig d'un descampat hi ha el James, el Rick i la Jess que acaba d'arribar.	ST-CA/Beneito_Satorres_CA/Beneito_Satorres_CA.eaf
Tots tres miren al voltant i intenten trobar l'origen del soroll.	ST-CA/Beneito_Satorres_CA/Beneito_Satorres_CA.eaf
Amb la mirada busquen d'on prové la veu.	ST-CA/Beneito_Satorres_CA/Beneito_Satorres_CA.eaf
El Rick segueix el James.	ST-CA/Beneito_Satorres_CA/Beneito_Satorres_CA.eaf
La Jess es queda estupefacta.	ST-CA/Beneito_Satorres_CA/Beneito_Satorres_CA.eaf
Els tres s'allunyen.	ST-CA/Beneito_Satorres_CA/Beneito_Satorres_CA.eaf
A un terrat, una dona francesa mulata d'uns 40 anys estén la roba mentre parla per telèfon en francès i diu:	ST-CA/Beneito_Satorres_CA/Beneito_Satorres_CA.eaf
Encara no l'he estès tota. He d'afanyar-me.	ST-CA/Beneito_Satorres_CA/Beneito_Satorres_CA.eaf
Però de què em parles?  Clar que he fet les maletes.	ST-CA/Beneito_Satorres_CA/Beneito_Satorres_CA.eaf
Escolta, ara no puc parlar. T'he de deixar.	ST-CA/Beneito_Satorres_CA/Beneito_Satorres_CA.eaf
Imprès en pantalla: "Zoé. La següent".	ST-CA/Beneito_Satorres_CA/Beneito_Satorres_CA.eaf
Sobre fons blanc, imprès en anglès: "què passa mentre..."	ST-CA/Beneito_Satorres_CA/Beneito_Satorres_CA.eaf
A primera hora del matí, fa un dia clar, tot i que està una mica ennuvolat.  Una parella i un gos caminen per un passeig de terra vora el mar i es creuen amb un noi que fa esport.	ST-CA/Bonjoch_Sara_CA/Bonjoch_Sara_CA.eaf
Al costat del passeig hi ha un carrer asfaltat i un cotxe blanc s'atura.	ST-CA/Bonjoch_Sara_CA/Bonjoch_Sara_CA.eaf
L'home que el condueix parla pel mòbil.	ST-CA/Bonjoch_Sara_CA/Bonjoch_Sara_CA.eaf
Va cap al maleter.	ST-CA/Bonjoch_Sara_CA/Bonjoch_Sara_CA.eaf
L'home, d'uns quaranta-cinc anys, és pèl-roig i duu barba.	ST-CA/Bonjoch_Sara_CA/Bonjoch_Sara_CA.eaf
Es posa unes ulleres de sol i mira cap a l'horitzó pensarós.	ST-CA/Bonjoch_Sara_CA/Bonjoch_Sara_CA.eaf
James, l'empresari.	ST-CA/Bonjoch_Sara_CA/Bonjoch_Sara_CA.eaf
En James camina pel passeig vora el mar, vesteix americana i corbata.	ST-CA/Bonjoch_Sara_CA/Bonjoch_Sara_CA.eaf
En James, sense samarreta, s'estira a la sorra cap per amunt.	ST-CA/Bonjoch_Sara_CA/Bonjoch_Sara_CA.eaf
Amb els ulls tancats, intenta relaxar-se.	ST-CA/Bonjoch_Sara_CA/Bonjoch_Sara_CA.eaf
Mira al seu voltant confós.	ST-CA/Bonjoch_Sara_CA/Bonjoch_Sara_CA.eaf
Està a una platja solitària i va amb vestit de bany.  S'aixeca i camina buscant alguna cosa mentre mira cap a l'infinit i al seu voltant desconcertat.	ST-CA/Bonjoch_Sara_CA/Bonjoch_Sara_CA.eaf
Torna cap a les seves coses a la sorra.	ST-CA/Bonjoch_Sara_CA/Bonjoch_Sara_CA.eaf
Però continua mirant a banda i banda, estranyat.	ST-CA/Bonjoch_Sara_CA/Bonjoch_Sara_CA.eaf
Agafa la seva roba i es vesteix. Es posa la camisa, sense deixar de mirar i fa cara d'amoïnat.	ST-CA/Bonjoch_Sara_CA/Bonjoch_Sara_CA.eaf
En James, camina per un carrer,	ST-CA/Bonjoch_Sara_CA/Bonjoch_Sara_CA.eaf
i després puja per un camí de terra escarpat.	ST-CA/Bonjoch_Sara_CA/Bonjoch_Sara_CA.eaf
Un home d'uns seixanta-cinc anys, sosté un got de café de cartró, mentre mira amunt pensatiu.	ST-CA/Bonjoch_Sara_CA/Bonjoch_Sara_CA.eaf
L'ensuma, se'l mira sense gaire delit i fa un glop.	ST-CA/Bonjoch_Sara_CA/Bonjoch_Sara_CA.eaf
Rick, el jubilat.	ST-CA/Bonjoch_Sara_CA/Bonjoch_Sara_CA.eaf
Té els cabells grisos, llargs i despentinats i duu barba i bigoti.  Porta una samarreta verda, de tirants, està assegut a un banc i mou la cama nerviós.	ST-CA/Bonjoch_Sara_CA/Bonjoch_Sara_CA.eaf
Deixa el cafè i treu un mòbil de la butxaca.	ST-CA/Bonjoch_Sara_CA/Bonjoch_Sara_CA.eaf
Mira la llista de contactes i en marca un.	ST-CA/Bonjoch_Sara_CA/Bonjoch_Sara_CA.eaf
Mira enlaire amb confusió.	ST-CA/Bonjoch_Sara_CA/Bonjoch_Sara_CA.eaf
Mira al seu voltant desconcertat.	ST-CA/Bonjoch_Sara_CA/Bonjoch_Sara_CA.eaf
S'allunya del banc, on hi deixa el café, i continua buscant mentre camina tot mirant amunt i a banda i banda.	ST-CA/Bonjoch_Sara_CA/Bonjoch_Sara_CA.eaf
Jess, l'estudiant.	ST-CA/Bonjoch_Sara_CA/Bonjoch_Sara_CA.eaf
La Jess té uns divuit anys i els cabells llargs arrissats.  Amb cara de confusió i de no entendre res, mira amunt i d'una banda a l'altra, una mica espantada.	ST-CA/Bonjoch_Sara_CA/Bonjoch_Sara_CA.eaf
Surt de la sala on estava estudiant i s'enfila per un camí costerut entre matolls.	ST-CA/Bonjoch_Sara_CA/Bonjoch_Sara_CA.eaf
Mira enrere, s'endinsa una mica més entre els matolls, i va a parar a un descampat sorrenc, envoltat d'arbres i turons, on també hi són en James i en Rick, que estan aturats i segueixen mirant enlaire i al seu voltant.	ST-CA/Bonjoch_Sara_CA/Bonjoch_Sara_CA.eaf
Tots tres resten immòbils i atònits sense deixar de mirar amunt i a banda i banda.	ST-CA/Bonjoch_Sara_CA/Bonjoch_Sara_CA.eaf
En Rick encongeix les espatlles i fa que no amb el cap.	ST-CA/Bonjoch_Sara_CA/Bonjoch_Sara_CA.eaf
Tots tres marxen plegats i s'endinsen al bosc.	ST-CA/Bonjoch_Sara_CA/Bonjoch_Sara_CA.eaf
Una noia negra, d'uns trenta-cinc anys, estén la roba a un terrat mentre parla pel mòbil.	ST-CA/Bonjoch_Sara_CA/Bonjoch_Sara_CA.eaf
M'he d'afanyar per acabar.	ST-CA/Bonjoch_Sara_CA/Bonjoch_Sara_CA.eaf
Sí, ja he fet les maletes. Ara no puc parlar, he de penjar.	ST-CA/Bonjoch_Sara_CA/Bonjoch_Sara_CA.eaf
Mira cap a l'infinit desconcertada i amb cara de confusió.	ST-CA/Bonjoch_Sara_CA/Bonjoch_Sara_CA.eaf
Zoe, la següent.	ST-CA/Bonjoch_Sara_CA/Bonjoch_Sara_CA.eaf
En lletres negres sobre fons blanc, què passa mentre...?	ST-CA/Bonjoch_Sara_CA/Bonjoch_Sara_CA.eaf
Direcció, guió i edició, Núria Nia. Director de fotografia, Albert Badia. So, Enrique Bermejo.	ST-CA/Bonjoch_Sara_CA/Bonjoch_Sara_CA.eaf
Produït per Transmedia Catalonia i La Panoràmica.	ST-CA/Bonjoch_Sara_CA/Bonjoch_Sara_CA.eaf
Actors per ordre d'aparició, James Hunter, Rick Zingale, Jessica Álvarez i Adeline Flaun.	ST-CA/Bonjoch_Sara_CA/Bonjoch_Sara_CA.eaf
En lletres negres, sobre fons blanc, i escrit en anglès: gaudiu del vostre temps.	ST-CA/Bonjoch_Sara_CA/Bonjoch_Sara_CA.eaf
A l'alba. El cel està ennuvolat. Un descampat davant de la platja.  Hi ha gent corrent i altra passejant un gos.	ST-CA/Colomer_Sandra_CA/Colomer_Sandra_CA.eaf
Davant del descampat un esportiu blanc s'atura. A dins hi ha una persona parlant pel telèfon.	ST-CA/Colomer_Sandra_CA/Colomer_Sandra_CA.eaf
Va al maleter.	ST-CA/Colomer_Sandra_CA/Colomer_Sandra_CA.eaf
Un home d'uns 40 anys, cabell curt, castany i barba.  Duu posat un vestit d'home. Es treu unes ulleres de sol de la butxaca interior i se les posa.	ST-CA/Colomer_Sandra_CA/Colomer_Sandra_CA.eaf
Es diu James i és l'empresari.  Camina pel descampat mirant el mòbil. Duu una bossa gran.	ST-CA/Colomer_Sandra_CA/Colomer_Sandra_CA.eaf
A la platja, en James s'estira sobre una tovallola.  	ST-CA/Colomer_Sandra_CA/Colomer_Sandra_CA.eaf
Es frega els ulls cansat.  	ST-CA/Colomer_Sandra_CA/Colomer_Sandra_CA.eaf
Mira al seu voltant.  	ST-CA/Colomer_Sandra_CA/Colomer_Sandra_CA.eaf
Mira entre les seves coses.  	ST-CA/Colomer_Sandra_CA/Colomer_Sandra_CA.eaf
S'aixeca.  	ST-CA/Colomer_Sandra_CA/Colomer_Sandra_CA.eaf
Camina mirant al seu voltant.  	ST-CA/Colomer_Sandra_CA/Colomer_Sandra_CA.eaf
S'atura i fa marxa enrere.  	ST-CA/Colomer_Sandra_CA/Colomer_Sandra_CA.eaf
Gira el cap confós.  	ST-CA/Colomer_Sandra_CA/Colomer_Sandra_CA.eaf
S'apropa a on hi ha les seves coses.  	ST-CA/Colomer_Sandra_CA/Colomer_Sandra_CA.eaf
Es vesteix mirant al seu voltant.  	ST-CA/Colomer_Sandra_CA/Colomer_Sandra_CA.eaf
Vestit, camina pel carrer.  	ST-CA/Colomer_Sandra_CA/Colomer_Sandra_CA.eaf
Puja pel mig de la muntanya.  	ST-CA/Colomer_Sandra_CA/Colomer_Sandra_CA.eaf
En un parc, un home d'uns 67 anys amb mitja melena gris despentinada i barba.  Vesteix una camisa sense tirans, una cadena al coll i té tatuatges al braç.	ST-CA/Colomer_Sandra_CA/Colomer_Sandra_CA.eaf
Està assentant en un banc amb un cafè a les mans.  	ST-CA/Colomer_Sandra_CA/Colomer_Sandra_CA.eaf
Beu una mica.  	ST-CA/Colomer_Sandra_CA/Colomer_Sandra_CA.eaf
Es diu Rick i és el jubilat.  	ST-CA/Colomer_Sandra_CA/Colomer_Sandra_CA.eaf
Té un tic nerviós en la cama dreta mentre fa glops al cafè.  	ST-CA/Colomer_Sandra_CA/Colomer_Sandra_CA.eaf
Treu un mòbil del pantaló.  	ST-CA/Colomer_Sandra_CA/Colomer_Sandra_CA.eaf
Es desplaça per la llista de contactes.  	ST-CA/Colomer_Sandra_CA/Colomer_Sandra_CA.eaf
Marca un dels noms.  	ST-CA/Colomer_Sandra_CA/Colomer_Sandra_CA.eaf
Mira al seu voltant.  	ST-CA/Colomer_Sandra_CA/Colomer_Sandra_CA.eaf
Torna a mirar al seu voltant.	ST-CA/Colomer_Sandra_CA/Colomer_Sandra_CA.eaf
S'aixeca i camina observant el seu entorn.	ST-CA/Colomer_Sandra_CA/Colomer_Sandra_CA.eaf
En una habitació una noia d'uns 17 anys amb cabells llargs, arrissats i pèl-rojos mira una pantalla d'ordinador.	ST-CA/Colomer_Sandra_CA/Colomer_Sandra_CA.eaf
Es diu Jess i és l'estudiant.	ST-CA/Colomer_Sandra_CA/Colomer_Sandra_CA.eaf
Busca el mòbil per la taula.	ST-CA/Colomer_Sandra_CA/Colomer_Sandra_CA.eaf
Mira el seu voltant.	ST-CA/Colomer_Sandra_CA/Colomer_Sandra_CA.eaf
Es sorprèn.  	ST-CA/Colomer_Sandra_CA/Colomer_Sandra_CA.eaf
S'aixeca i surt al carrer.  	ST-CA/Colomer_Sandra_CA/Colomer_Sandra_CA.eaf
Camina per la muntanya.  	ST-CA/Colomer_Sandra_CA/Colomer_Sandra_CA.eaf
En mig d'un descampat a la muntanya hi ha en James, en Rick. La Jess camina cap a ells.  	ST-CA/Colomer_Sandra_CA/Colomer_Sandra_CA.eaf
Els tres miren el seu voltant.  	ST-CA/Colomer_Sandra_CA/Colomer_Sandra_CA.eaf
Els tres miren confosos pel seu voltant.  	ST-CA/Colomer_Sandra_CA/Colomer_Sandra_CA.eaf
Es miren entre ells.  	ST-CA/Colomer_Sandra_CA/Colomer_Sandra_CA.eaf
Neguen amb el cap.  	ST-CA/Colomer_Sandra_CA/Colomer_Sandra_CA.eaf
La Jess fa cara pensativa.  	ST-CA/Colomer_Sandra_CA/Colomer_Sandra_CA.eaf
Els tres caminen junts parlant entre ells.  	ST-CA/Colomer_Sandra_CA/Colomer_Sandra_CA.eaf
En el terrat d'una casa una dona de pell fosca parla per telèfon mentre estén la roba.  	ST-CA/Colomer_Sandra_CA/Colomer_Sandra_CA.eaf
No, encara no l'he estès tota. M'he d'afanyar a acabar.  	ST-CA/Colomer_Sandra_CA/Colomer_Sandra_CA.eaf
No, però de què hem parles? Sí, esclar, ja he fet les maletes.  	ST-CA/Colomer_Sandra_CA/Colomer_Sandra_CA.eaf
Escolta, ara no puc parlar. T'he de deixar.  	ST-CA/Colomer_Sandra_CA/Colomer_Sandra_CA.eaf
La dona es diu Zoe. Mira al seu voltant. És la següent.  	ST-CA/Colomer_Sandra_CA/Colomer_Sandra_CA.eaf
Sobre fons blanc en lletres negres: Què passa mentre, seguit d'una línia.  	ST-CA/Colomer_Sandra_CA/Colomer_Sandra_CA.eaf
A la tarda, per un passeig a la vora del mar, un home amb xandall passa corrent i una parella passeja un gos gran. La claror és pàl·lida i a l'horitzó es veuen núvols blancs.	ST-CA/Juan_Magdalena_CA/Juan_Magdalena_CA.eaf
En James és un empresari d'uns 45 anys, amb els cabells castanys curts i barba. Deixa un maletí dins el cotxe, es mira el mar i es posa unes ulleres de sol.  	ST-CA/Juan_Magdalena_CA/Juan_Magdalena_CA.eaf
És a la sorra i porta una bossa de platja. Agafa el mòbil.  	ST-CA/Juan_Magdalena_CA/Juan_Magdalena_CA.eaf
En James va sense camisa i es tomba sobre una tovallola que està damunt la sorra.  	ST-CA/Juan_Magdalena_CA/Juan_Magdalena_CA.eaf
Té els ulls tancats i, al cap d'un moment, passa una mà per sobre l'arena i hi juga amb els dits, tanquil·lament.  	ST-CA/Juan_Magdalena_CA/Juan_Magdalena_CA.eaf
S'incorpora.  	ST-CA/Juan_Magdalena_CA/Juan_Magdalena_CA.eaf
Es gira.  	ST-CA/Juan_Magdalena_CA/Juan_Magdalena_CA.eaf
Busca amb la mirada al seu voltant.  	ST-CA/Juan_Magdalena_CA/Juan_Magdalena_CA.eaf
Deixa el mòbil i s'aixeca. Porta un banyador.  	ST-CA/Juan_Magdalena_CA/Juan_Magdalena_CA.eaf
S'acosta a l'aigua i camina lentament. Va moguent el cap, buscant alguna cosa amb la mirada. S'allunya una mica de l'aigua i es queda parat, mirant lluny, cap a la sorra. Al fons es veuen uns gratacels.  	ST-CA/Juan_Magdalena_CA/Juan_Magdalena_CA.eaf
Es dirigeix cap a la tovallola.  	ST-CA/Juan_Magdalena_CA/Juan_Magdalena_CA.eaf
Torna a mirar darrera seu.  	ST-CA/Juan_Magdalena_CA/Juan_Magdalena_CA.eaf
Es torna a acostar a l'aigua.  	ST-CA/Juan_Magdalena_CA/Juan_Magdalena_CA.eaf
Segueix el so amb la mirada. Torna cap a la tovallola i es posa la camisa.  	ST-CA/Juan_Magdalena_CA/Juan_Magdalena_CA.eaf
Vestit amb la roba d'executiu, camina per un passeig amb arbres.  	ST-CA/Juan_Magdalena_CA/Juan_Magdalena_CA.eaf
Puja per un turó àrid i amb vegetació seca.  	ST-CA/Juan_Magdalena_CA/Juan_Magdalena_CA.eaf
En Rick és un jubilat d'uns 65 anys. Té els cabells grisos i porta barba.  	ST-CA/Juan_Magdalena_CA/Juan_Magdalena_CA.eaf
Està assegut a un banc d'un parc i té un cafè per emportar a les mans.  	ST-CA/Juan_Magdalena_CA/Juan_Magdalena_CA.eaf
Li treu la tapa al cafè.  	ST-CA/Juan_Magdalena_CA/Juan_Magdalena_CA.eaf
Es mira el cafè, pensatiu, i en pega un bon glop. Té la mirada perduda.  	ST-CA/Juan_Magdalena_CA/Juan_Magdalena_CA.eaf
Deixa la tapa del cafè sobre el banc del costat i torna a beure. Mou la cama dreta cap amunt i cap avall, amb un gest nerviós. Fa que no amb el cap, amolla el got de cafè al costat de la tapa i pica de mans, contemplatiu.  	ST-CA/Juan_Magdalena_CA/Juan_Magdalena_CA.eaf
Es treu el mòbil de la butxaca de darrere dels pantalons i mira els contactes.  	ST-CA/Juan_Magdalena_CA/Juan_Magdalena_CA.eaf
Escull un número i hi truca.  	ST-CA/Juan_Magdalena_CA/Juan_Magdalena_CA.eaf
Fa cara d'estranyat i busca amb la mirada.  	ST-CA/Juan_Magdalena_CA/Juan_Magdalena_CA.eaf
Arrufa les celles.  	ST-CA/Juan_Magdalena_CA/Juan_Magdalena_CA.eaf
Torna a mirar.  	ST-CA/Juan_Magdalena_CA/Juan_Magdalena_CA.eaf
S'aixeca i se'n va, deixant el got de cafè sobre el banc. Es gira.  	ST-CA/Juan_Magdalena_CA/Juan_Magdalena_CA.eaf
Mira a darrere, com si busqués alguna cosa, i marxa.  	ST-CA/Juan_Magdalena_CA/Juan_Magdalena_CA.eaf
La Jess és una estudiant amb els cabells castanys arrissats.  	ST-CA/Juan_Magdalena_CA/Juan_Magdalena_CA.eaf
Està assaguda i té un llàpis a les mans.  	ST-CA/Juan_Magdalena_CA/Juan_Magdalena_CA.eaf
Busca amb la mirada al seu voltant, estranyada.  	ST-CA/Juan_Magdalena_CA/Juan_Magdalena_CA.eaf
S'aixeca i marxa.  	ST-CA/Juan_Magdalena_CA/Juan_Magdalena_CA.eaf
Camina per un camí de terra, envoltat de plantes. Porta una jaqueta llarga i botes.  	ST-CA/Juan_Magdalena_CA/Juan_Magdalena_CA.eaf
Puja pel camí i es gira a mirar a darrere.  	ST-CA/Juan_Magdalena_CA/Juan_Magdalena_CA.eaf
Es torna a girar cap a davant i camina amb pressa.  	ST-CA/Juan_Magdalena_CA/Juan_Magdalena_CA.eaf
Al mig d'un camp àrid hi ha en James i en Rick, que miren als voltants, desconcertats. La Jess se'ls hi acosta.  	ST-CA/Juan_Magdalena_CA/Juan_Magdalena_CA.eaf
Tots tres miren buscant d'on ve la veu, sorpresos.  	ST-CA/Juan_Magdalena_CA/Juan_Magdalena_CA.eaf
Miren als voltants.  	ST-CA/Juan_Magdalena_CA/Juan_Magdalena_CA.eaf
Té una mà al cap i s'arronsa d'espatlles.  	ST-CA/Juan_Magdalena_CA/Juan_Magdalena_CA.eaf
En Rick allarga el braç i nega amb el cap.  	ST-CA/Juan_Magdalena_CA/Juan_Magdalena_CA.eaf
La Jess el mira.  	ST-CA/Juan_Magdalena_CA/Juan_Magdalena_CA.eaf
En Rick se'ls mira incrèdul.  	ST-CA/Juan_Magdalena_CA/Juan_Magdalena_CA.eaf
En James aixeca la vista i se'l mira.  	ST-CA/Juan_Magdalena_CA/Juan_Magdalena_CA.eaf
Els tres es queden parats, mirant-se.  	ST-CA/Juan_Magdalena_CA/Juan_Magdalena_CA.eaf
Es miren pensatius. En Rick s'arronsa d'espatlles i nega amb el cap. La Jess també fa que no.  	ST-CA/Juan_Magdalena_CA/Juan_Magdalena_CA.eaf
Aixequen els braços i miren al voltant.  	ST-CA/Juan_Magdalena_CA/Juan_Magdalena_CA.eaf
Comencen a marxar. La Jess es queda pensativa i somriu.  	ST-CA/Juan_Magdalena_CA/Juan_Magdalena_CA.eaf
Marxen per allà on havia vingut la Jess, que se'ls hi acosta corrent. Es posa enmig dels dos, que li posen una mà a l'esquena cadascun, amb un gest amigable. Van caminant tranquil·lament, a un pas desperocupat.  	ST-CA/Juan_Magdalena_CA/Juan_Magdalena_CA.eaf
La Zoé és a dalt d'un terrat, estenent roba. És una dona de color.  	ST-CA/Juan_Magdalena_CA/Juan_Magdalena_CA.eaf
No, encara no l'he estès tota. M'he d'afanyar a acabar.  	ST-CA/Juan_Magdalena_CA/Juan_Magdalena_CA.eaf
No, però de què em parles? Sí, esclar, ja he fet les maletes...  	ST-CA/Juan_Magdalena_CA/Juan_Magdalena_CA.eaf
Mira al seu voltant, desconcertada.  	ST-CA/Juan_Magdalena_CA/Juan_Magdalena_CA.eaf
Escolta, ara no puc parlar. T'he de deixar.  	ST-CA/Juan_Magdalena_CA/Juan_Magdalena_CA.eaf
És la següent.  	ST-CA/Juan_Magdalena_CA/Juan_Magdalena_CA.eaf
Què passa mentre...?  	ST-CA/Juan_Magdalena_CA/Juan_Magdalena_CA.eaf
De bon matí, en una platja gairebé deserta, una parella passeja un gos i un home corre. Està ennuvolat. 	ST-CA/Mor_Polo_CA/Mor_Polo_CA.eaf
Un cotxe blanc de gamma alta aparca davant de la platja. De dins surt un home d’uns 40 anys vestit d’etiqueta parlant per telèfon. Guarda el maletí que duu al maleter i agafa una bossa de platja.	ST-CA/Mor_Polo_CA/Mor_Polo_CA.eaf
L’home és pèl-roig i duu barba i bigoti. Preocupat, mira cap al mar i es posa unes ulleres de sol. 	ST-CA/Mor_Polo_CA/Mor_Polo_CA.eaf
Sobreimprès en pantalla: James, l’empresari.	ST-CA/Mor_Polo_CA/Mor_Polo_CA.eaf
Mentre camina per la platja, en James fa una altra trucada.	ST-CA/Mor_Polo_CA/Mor_Polo_CA.eaf
Ara sense samarreta, s’estira a la tovallola.	ST-CA/Mor_Polo_CA/Mor_Polo_CA.eaf
Amb els ulls tancats, acaricia l’arena. 	ST-CA/Mor_Polo_CA/Mor_Polo_CA.eaf
S’incorpora malhumorat. 	ST-CA/Mor_Polo_CA/Mor_Polo_CA.eaf
Estranyat, mira a un costat i a l’altre. 	ST-CA/Mor_Polo_CA/Mor_Polo_CA.eaf
S’aixeca i, amb la mateixa expressió d’estranyesa, camina per l’arena mirant al seu voltant, intentant esbrinar d’on ve el so. Duu un banyador negre.	ST-CA/Mor_Polo_CA/Mor_Polo_CA.eaf
Segueix caminant, però cada cop que sent el so, s’atura i mira a una banda i a l’altra.	ST-CA/Mor_Polo_CA/Mor_Polo_CA.eaf
Desconcertat, s’apropa a l’aigua i se’n torna a allunyar.	ST-CA/Mor_Polo_CA/Mor_Polo_CA.eaf
Sense deixar de mirar al seu voltant, es vesteix.	ST-CA/Mor_Polo_CA/Mor_Polo_CA.eaf
Ara, vestit un altre cop d’etiqueta, camina per fora la platja.	ST-CA/Mor_Polo_CA/Mor_Polo_CA.eaf
S’enfila per un turó.	ST-CA/Mor_Polo_CA/Mor_Polo_CA.eaf
Al mateix temps, en un parc, un senyor d’uns 60 anys, amb els cabells grisos i esvalotats i la barba deixada, està assegut subjectant un got de plàstic entre les mans. 	ST-CA/Mor_Polo_CA/Mor_Polo_CA.eaf
Somriu i nega amb el cap.	ST-CA/Mor_Polo_CA/Mor_Polo_CA.eaf
Destapa el got de plàstic i a l’interior s’hi veu café sol. 	ST-CA/Mor_Polo_CA/Mor_Polo_CA.eaf
Abans de fer-ne un glop, s’ho pensa.	ST-CA/Mor_Polo_CA/Mor_Polo_CA.eaf
Finalment, beu.	ST-CA/Mor_Polo_CA/Mor_Polo_CA.eaf
Sobreimprès en pantalla: Rick, el jubilat.	ST-CA/Mor_Polo_CA/Mor_Polo_CA.eaf
Duu una samarreta de tirants de color caqui per dins dels pantalons, que són negres. Les sabates que porta també són de color negre i al coll duu una cadena. Mentre mou una cama amb nerviosisme, deixa el café al banc del costat, pica de mans i es frega els braços. 	ST-CA/Mor_Polo_CA/Mor_Polo_CA.eaf
Agafa el mòbil, busca un número a l’agenda i truca. 	ST-CA/Mor_Polo_CA/Mor_Polo_CA.eaf
Estranyat, mira cap amunt.	ST-CA/Mor_Polo_CA/Mor_Polo_CA.eaf
Torna a mirar cap a dalt.	ST-CA/Mor_Polo_CA/Mor_Polo_CA.eaf
Deixa el cafè damunt d’un banc i marxa mirant a un costat i a l’altre.	ST-CA/Mor_Polo_CA/Mor_Polo_CA.eaf
En una casa, una noia d’uns 20 anys està asseguda davant d’un escriptori amb un ordinador i apunts i llibres damunt la taula.	ST-CA/Mor_Polo_CA/Mor_Polo_CA.eaf
Jess, l’estudiant. 	ST-CA/Mor_Polo_CA/Mor_Polo_CA.eaf
Rebusca entre les coses i agafa el telèfon mòbil.	ST-CA/Mor_Polo_CA/Mor_Polo_CA.eaf
La Jess, que és pèl-roja i té els cabells arrissats, mira amb expressió de desconcert al seu voltant. 	ST-CA/Mor_Polo_CA/Mor_Polo_CA.eaf
S’aixeca i marxa de casa.	ST-CA/Mor_Polo_CA/Mor_Polo_CA.eaf
Un cop fora, sense deixar de mirar d’una banda a l’altra, puja per un turó ple de plantes i arbustos. 	ST-CA/Mor_Polo_CA/Mor_Polo_CA.eaf
Va a parar a una esplanada de terra on també hi són en James i en Rick, que miren a un costat i a l’altre.	ST-CA/Mor_Polo_CA/Mor_Polo_CA.eaf
La Jess s’apropa a ells.	ST-CA/Mor_Polo_CA/Mor_Polo_CA.eaf
Desconcertats, tots miren al cel i al seu voltant.	ST-CA/Mor_Polo_CA/Mor_Polo_CA.eaf
A en James li canvia l’expressió.	ST-CA/Mor_Polo_CA/Mor_Polo_CA.eaf
En Rick es posa la mà al front.	ST-CA/Mor_Polo_CA/Mor_Polo_CA.eaf
Es miren entre ells i fan que no amb el cap. 	ST-CA/Mor_Polo_CA/Mor_Polo_CA.eaf
En Rick alça els braços. 	ST-CA/Mor_Polo_CA/Mor_Polo_CA.eaf
En James fa cara d’incrèdul. 	ST-CA/Mor_Polo_CA/Mor_Polo_CA.eaf
La Jess, encara sorpresa, somriu i s’hi afegeix.	ST-CA/Mor_Polo_CA/Mor_Polo_CA.eaf
Marxen els tres junts.	ST-CA/Mor_Polo_CA/Mor_Polo_CA.eaf
En un terrat, una dona negra estén roba mentre parla per telèfon.	ST-CA/Mor_Polo_CA/Mor_Polo_CA.eaf
No, encara no l’he estès tota. M’he d’afanyar a acabar1.	ST-CA/Mor_Polo_CA/Mor_Polo_CA.eaf
No, però de què em parles? Sí, és clar, ja he fet les maletes…2	ST-CA/Mor_Polo_CA/Mor_Polo_CA.eaf
Estranyada, mira al seu voltant.	ST-CA/Mor_Polo_CA/Mor_Polo_CA.eaf
Escolta, ara no puc parlar. T’he de deixar.3	ST-CA/Mor_Polo_CA/Mor_Polo_CA.eaf
Sobreimprès en pantalla: Zoé, la següent. 	ST-CA/Mor_Polo_CA/Mor_Polo_CA.eaf
Sobreimprès en pantalla: what happens while…	ST-CA/Mor_Polo_CA/Mor_Polo_CA.eaf
