En una playa, y bajo un cielo parcialmente nublado, se cruzan por la arena una pareja que pasea a un perro de gran tamaño y un hombre haciendo footing.	WHW-ES-Pr/Aptent-ES/Aptent-ES.eaf
El perro olisquea.	WHW-ES-Pr/Aptent-ES/Aptent-ES.eaf
Al oír el silbido corre con sus amos. Sobreimpreso con fondo blanco:	WHW-ES-Pr/Aptent-ES/Aptent-ES.eaf
Junto a la playa se detiene un coche blanco de alta gama. Saldrá el conductor hablando por el móvil, guardará su maletín en el maletero y cogerá un bolso de playa azul y blanco.	WHW-ES-Pr/Aptent-ES/Aptent-ES.eaf
Cuelga y guarda el móvil. Se lleva la mano al bolsillo interior del traje.	WHW-ES-Pr/Aptent-ES/Aptent-ES.eaf
Se pone unas gafas de sol de aviador doradas y mira al frente.	WHW-ES-Pr/Aptent-ES/Aptent-ES.eaf
Sobreimpreso: James, el empresario. Caminando por la playa se lleva el móvil a la oreja.	WHW-ES-Pr/Aptent-ES/Aptent-ES.eaf
Se tiende boca arriba y en bañador sobre una toalla. Deja el móvil junto a sus pertenencias.	WHW-ES-Pr/Aptent-ES/Aptent-ES.eaf
Permanece unos segundos con los ojos cerrados. Se lleva las manos a la cara y luego extiende los brazos sobre la arena. Con la mano recoge unos granos y los deja caer lentamente.	WHW-ES-Pr/Aptent-ES/Aptent-ES.eaf
Se incorpora y coge el móvil.	WHW-ES-Pr/Aptent-ES/Aptent-ES.eaf
Preocupado busca algo entre sus pertenencias.	WHW-ES-Pr/Aptent-ES/Aptent-ES.eaf
Deja el móvil a un lado y se levanta.	WHW-ES-Pr/Aptent-ES/Aptent-ES.eaf
Se aleja unos metros de la toalla mirando a lo lejos, en dirección al paseo marítimo.	WHW-ES-Pr/Aptent-ES/Aptent-ES.eaf
Se detiene y centra su atención en un punto fijo. Una gaviota vuela a unos metros de él agitando las alas con ímpetu.	WHW-ES-Pr/Aptent-ES/Aptent-ES.eaf
Dirige la mirada de un lado a otro de la playa, como desorientado.	WHW-ES-Pr/Aptent-ES/Aptent-ES.eaf
Da media vuelta y sin dejar de mirar en todas direcciones se acerca a la orilla.	WHW-ES-Pr/Aptent-ES/Aptent-ES.eaf
Su rostro denota cierta inquietud. Camina de vuelta hacia la toalla sin prestar atención a sus pasos. Dos yates surcan el mar.	WHW-ES-Pr/Aptent-ES/Aptent-ES.eaf
Se inclina ligeramente para recoger la camisa y vuelve a alzar la mirada mientras se la pone. Después se agacha para recoger el resto de la ropa y seguir vistiéndose.	WHW-ES-Pr/Aptent-ES/Aptent-ES.eaf
Camina por un largo paseo rodeado de árboles de abundante follaje. Tiene el cuello de la camisa desabrochado y ya no lleva corbata.	WHW-ES-Pr/Aptent-ES/Aptent-ES.eaf
Sube por una montaña a través de un estrecho sendero pedregoso.	WHW-ES-Pr/Aptent-ES/Aptent-ES.eaf
Un hombre de mediana edad con barba canosa y ligeramente descuidada está sentado en un banco individual rodeado de vegetación. Sostiene un vaso de plástico con tapa y tamborilea sobre él con el dedo índice de la mano izquierda.	WHW-ES-Pr/Aptent-ES/Aptent-ES.eaf
Sonríe y dice que no con la cabeza. Continúa tocando el vaso como nervioso y finalmente quita la tapa. Contiene café solo.	WHW-ES-Pr/Aptent-ES/Aptent-ES.eaf
Mira el interior del vaso, bebe un trago y lo saborea.	WHW-ES-Pr/Aptent-ES/Aptent-ES.eaf
Sobreimpreso: Rick, el jubilado. Deja la tapa en uno de los dos bancos individuales que tiene a cada lado. Después bebe otro trago de café sin dejar de mover la pierna derecha nervioso.	WHW-ES-Pr/Aptent-ES/Aptent-ES.eaf
Deja el vaso junto a la tapa y da unas palmadas.	WHW-ES-Pr/Aptent-ES/Aptent-ES.eaf
Saca el móvil del bolsillo trasero del pantalón. Accede a la sección "contactos" y desliza el dedo por la pantalla hasta detenerse en Craig Anderson.	WHW-ES-Pr/Aptent-ES/Aptent-ES.eaf
Pulsa llamar con gesto de fastidio.	WHW-ES-Pr/Aptent-ES/Aptent-ES.eaf
Gesto de impotencia.	WHW-ES-Pr/Aptent-ES/Aptent-ES.eaf
De repente frunce el ceño y alza la mirada.	WHW-ES-Pr/Aptent-ES/Aptent-ES.eaf
Extrañado.	WHW-ES-Pr/Aptent-ES/Aptent-ES.eaf
Mueve la mano intentando explicarse.	WHW-ES-Pr/Aptent-ES/Aptent-ES.eaf
Vuelve a alzar la mirada extrañado.	WHW-ES-Pr/Aptent-ES/Aptent-ES.eaf
Esboza una pequeña sonrisa.	WHW-ES-Pr/Aptent-ES/Aptent-ES.eaf
El vaso de plástico reposa sobre el banco con la tapa puesta. Él se aleja mirando inquieto en todas direcciones y se adentra en un sendero. Una joven pelirroja con rizos está sentada frente a un ordenador portátil rodeada de apuntes.  Muerde el lápiz con hastío.	WHW-ES-Pr/Aptent-ES/Aptent-ES.eaf
Sobreimpreso: Jess, la estudiante.	WHW-ES-Pr/Aptent-ES/Aptent-ES.eaf
Busca el móvil.	WHW-ES-Pr/Aptent-ES/Aptent-ES.eaf
Finalmente lo encuentra entre los papeles. Descuelga y se lo lleva a la oreja.	WHW-ES-Pr/Aptent-ES/Aptent-ES.eaf
Arquea las cejas.	WHW-ES-Pr/Aptent-ES/Aptent-ES.eaf
Mueve la mano alterada.	WHW-ES-Pr/Aptent-ES/Aptent-ES.eaf
Mira hacia ambos lados, con gesto de extrañeza y temor. Ligeramente aliviada por el cese del ruido, baja la mirada para seguir estudiando.	WHW-ES-Pr/Aptent-ES/Aptent-ES.eaf
Se levanta de la silla.	WHW-ES-Pr/Aptent-ES/Aptent-ES.eaf
Ha salido a la calle con un abrigo marrón y un fular negro con estampado blanco. Sube una pendiente llena de vegetación.	WHW-ES-Pr/Aptent-ES/Aptent-ES.eaf
De repente gira la cabeza como intentando averiguar de dónde viene el sonido y prosigue su camino.	WHW-ES-Pr/Aptent-ES/Aptent-ES.eaf
Llega a una explanada y camina lentamente hacia James y Rick, que también están allí. Los tres dan vueltas sobre sí mismos moviendo la cabeza desconcertados. Les sorprende una voz.	WHW-ES-Pr/Aptent-ES/Aptent-ES.eaf
James mira a lo lejos haciendo visera con la mano para evitar el intenso sol.	WHW-ES-Pr/Aptent-ES/Aptent-ES.eaf
James da un paso adelante.	WHW-ES-Pr/Aptent-ES/Aptent-ES.eaf
Buscan.	WHW-ES-Pr/Aptent-ES/Aptent-ES.eaf
Gesto angustiado.	WHW-ES-Pr/Aptent-ES/Aptent-ES.eaf
Los mira fijamente.	WHW-ES-Pr/Aptent-ES/Aptent-ES.eaf
Jess escucha atenta.	WHW-ES-Pr/Aptent-ES/Aptent-ES.eaf
Serio.	WHW-ES-Pr/Aptent-ES/Aptent-ES.eaf
James reflexivo.	WHW-ES-Pr/Aptent-ES/Aptent-ES.eaf
Gestos de inquietud.	WHW-ES-Pr/Aptent-ES/Aptent-ES.eaf
James mira a Rick que parece dudar y Jess niega con la cabeza.	WHW-ES-Pr/Aptent-ES/Aptent-ES.eaf
Se mantiene expectante.	WHW-ES-Pr/Aptent-ES/Aptent-ES.eaf
De repente Rick abre los brazos.	WHW-ES-Pr/Aptent-ES/Aptent-ES.eaf
Sonríe.	WHW-ES-Pr/Aptent-ES/Aptent-ES.eaf
Mirando al cielo.	WHW-ES-Pr/Aptent-ES/Aptent-ES.eaf
James retrocede unos pasos.	WHW-ES-Pr/Aptent-ES/Aptent-ES.eaf
James se marcha con las manos en los bolsillos. Rick se apresura a alcanzarlo.	WHW-ES-Pr/Aptent-ES/Aptent-ES.eaf
Jess corre con ellos. Cuando los alcanza, James le da unas palmadas en la espalda. Mientras hablan se van alejando poco a poco en dirección a la vegetación.	WHW-ES-Pr/Aptent-ES/Aptent-ES.eaf
Una mujer negra tiende la ropa con el móvil sujeto entre la cabeza y el hombro izquierdo.	WHW-ES-Pr/Aptent-ES/Aptent-ES.eaf
No, no he terminado de tenderla. Tengo que darme prisa.	WHW-ES-Pr/Aptent-ES/Aptent-ES.eaf
No, ¿de qué me hablas? Sí, claro, las maletas están a punto...	WHW-ES-Pr/Aptent-ES/Aptent-ES.eaf
Mira extrañada a su alrededor.	WHW-ES-Pr/Aptent-ES/Aptent-ES.eaf
Oye, ahora no puedo hablar. Tengo que dejarte.	WHW-ES-Pr/Aptent-ES/Aptent-ES.eaf
Asustada y con la mirada perdida. Sobreimpreso: Zoé, la próxima. En negro y sobre fondo blanco: ¿qué pasa mientras...?	WHW-ES-Pr/Aptent-ES/Aptent-ES.eaf
Una pareja con un gran danés camina por la playa. Se cruzan con un corredor que va en sentido contrario. El día es gris y van abrigados.	WHW-ES-Pr/Aristia-ES/Aristia-ES.eaf
Rótulo sobre la pantalla blanca.	WHW-ES-Pr/Aristia-ES/Aristia-ES.eaf
Un BMW blanco se detiene frente a la playa. El conductor habla por el móvil. 	WHW-ES-Pr/Aristia-ES/Aristia-ES.eaf
Se apea.	WHW-ES-Pr/Aristia-ES/Aristia-ES.eaf
Ronda los cincuenta años, con pelo rubio, bigote y barba recortada. Ha dejado un maletín en el maletero del coche y ha sacado una bolsa.	WHW-ES-Pr/Aristia-ES/Aristia-ES.eaf
Se pone gafas de sol. Un letrero anuncia: James, el empresario.	WHW-ES-Pr/Aristia-ES/Aristia-ES.eaf
Camina por la playa manipulando el móvil y con la bolsa al hombro.	WHW-ES-Pr/Aristia-ES/Aristia-ES.eaf
Se tumba boca arriba sobre una toalla en la arena, junto a su ropa. Lleva bañador negro. Cierra los ojos.	WHW-ES-Pr/Aristia-ES/Aristia-ES.eaf
Se los frota y los abre.	WHW-ES-Pr/Aristia-ES/Aristia-ES.eaf
Se incorpora y coge el móvil.	WHW-ES-Pr/Aristia-ES/Aristia-ES.eaf
Escucha intrigado.	WHW-ES-Pr/Aristia-ES/Aristia-ES.eaf
Mira a su alrededor.	WHW-ES-Pr/Aristia-ES/Aristia-ES.eaf
Busca con la mirada. 	WHW-ES-Pr/Aristia-ES/Aristia-ES.eaf
Se levanta.	WHW-ES-Pr/Aristia-ES/Aristia-ES.eaf
Camina por la playa, cerca de la orilla, escuchando atento y mirando a su alrededor.	WHW-ES-Pr/Aristia-ES/Aristia-ES.eaf
Gira hacia su ropa.	WHW-ES-Pr/Aristia-ES/Aristia-ES.eaf
Se detiene y mira de nuevo al cielo.	WHW-ES-Pr/Aristia-ES/Aristia-ES.eaf
Camina intrigado, buscando con la mirada.	WHW-ES-Pr/Aristia-ES/Aristia-ES.eaf
Coge la camisa y se la pone.	WHW-ES-Pr/Aristia-ES/Aristia-ES.eaf
Vestido con su traje negro, camina por una zona arbolada.	WHW-ES-Pr/Aristia-ES/Aristia-ES.eaf
Sube una ladera cubierta por matorral bajo.	WHW-ES-Pr/Aristia-ES/Aristia-ES.eaf
Un hombre repiquetea cobre un vaso de plástico. Lleva guedejas, bigote y barba entrecanos. Mira triste al frente. Lleva una camiseta de tirantes verdosa y una cadena al cuello.	WHW-ES-Pr/Aristia-ES/Aristia-ES.eaf
Pasa el dedo sobre la tapa del vaso.	WHW-ES-Pr/Aristia-ES/Aristia-ES.eaf
La quita. El vaso contiene café.	WHW-ES-Pr/Aristia-ES/Aristia-ES.eaf
Se acerca el vaso a los labios y o mira pensativo. 	WHW-ES-Pr/Aristia-ES/Aristia-ES.eaf
Bebe.	WHW-ES-Pr/Aristia-ES/Aristia-ES.eaf
Un cartel anuncia: Rick, el jubilado.	WHW-ES-Pr/Aristia-ES/Aristia-ES.eaf
Rick deja la tapa en un banco cercano al suyo. Está entre los árboles de un parque. Mueve rítmicamente la pierna derecha	WHW-ES-Pr/Aristia-ES/Aristia-ES.eaf
Deja el vaso en el banco contiguo y mira al cielo.	WHW-ES-Pr/Aristia-ES/Aristia-ES.eaf
Saca un móvil y busca en los contactos.	WHW-ES-Pr/Aristia-ES/Aristia-ES.eaf
Selecciona uno y llama.	WHW-ES-Pr/Aristia-ES/Aristia-ES.eaf
Mira intrigado al cielo.	WHW-ES-Pr/Aristia-ES/Aristia-ES.eaf
Mira de nuevo al cielo.	WHW-ES-Pr/Aristia-ES/Aristia-ES.eaf
Se levanta mirando al cielo y se aleja de los bancos, sobre los que queda el vaso de plástico.	WHW-ES-Pr/Aristia-ES/Aristia-ES.eaf
La estudiante Jess ronda los veinte años. Es pelirroja con la melena rizada. Está pensativa sentada ante su portátil.	WHW-ES-Pr/Aristia-ES/Aristia-ES.eaf
Busca por la mesa.	WHW-ES-Pr/Aristia-ES/Aristia-ES.eaf
Coge el móvil.	WHW-ES-Pr/Aristia-ES/Aristia-ES.eaf
Mira intrigada a su alrededor.	WHW-ES-Pr/Aristia-ES/Aristia-ES.eaf
Se levanta.	WHW-ES-Pr/Aristia-ES/Aristia-ES.eaf
Camina por la calle con un anorak puesto. Mira extrañada a su alrededor	WHW-ES-Pr/Aristia-ES/Aristia-ES.eaf
Sube una ladera entre plantas de maíz.	WHW-ES-Pr/Aristia-ES/Aristia-ES.eaf
Se detiene y mira hacia atrás.	WHW-ES-Pr/Aristia-ES/Aristia-ES.eaf
Sube corriendo hacia su izquierda	WHW-ES-Pr/Aristia-ES/Aristia-ES.eaf
Llaga a una explanada terrosa, en la que están Rick y James. Todos miran extrañados a su alrededor.	WHW-ES-Pr/Aristia-ES/Aristia-ES.eaf
Miran al cielo, mientras escuchan asombrados la voz en off.	WHW-ES-Pr/Aristia-ES/Aristia-ES.eaf
Rick gesticula incrédulo.	WHW-ES-Pr/Aristia-ES/Aristia-ES.eaf
Se miran entre ellos. Rick niega.	WHW-ES-Pr/Aristia-ES/Aristia-ES.eaf
Miran al cielo desde la explanada.	WHW-ES-Pr/Aristia-ES/Aristia-ES.eaf
Rick camina tras James.	WHW-ES-Pr/Aristia-ES/Aristia-ES.eaf
Jessica queda pensativa y sonríe.	WHW-ES-Pr/Aristia-ES/Aristia-ES.eaf
Va tras ellos, que caminan hacia la vegetación que rodea la explanada.	WHW-ES-Pr/Aristia-ES/Aristia-ES.eaf
La imagen funde a negro. Una mujer tiende ropa y sujeta el móvil sobre el hombro. No, no he terminado de tenderla. Tengo que darme prisa.	WHW-ES-Pr/Aristia-ES/Aristia-ES.eaf
No, ¿de qué me hablas? Sí, claro, las maletas están a punto…	WHW-ES-Pr/Aristia-ES/Aristia-ES.eaf
Mira intrigada a su alrededor.	WHW-ES-Pr/Aristia-ES/Aristia-ES.eaf
Oye, ahora no puedo hablar. Tengo que dejarte. Guarda el móvil.	WHW-ES-Pr/Aristia-ES/Aristia-ES.eaf
Zoé, la próxima. Es negra y ronda los veinte. 	WHW-ES-Pr/Aristia-ES/Aristia-ES.eaf
¿Qué pasa mientras…?	WHW-ES-Pr/Aristia-ES/Aristia-ES.eaf
Al amanecer, una pareja pasea con su perro por la playa.	WHW-ES-Pr/CEIAF-ES/CEIAF-ES.eaf
Se cruzan con un hombre que va corriendo en chándal.	WHW-ES-Pr/CEIAF-ES/CEIAF-ES.eaf
Un BMW de color blanco se detiene en el paseo marítimo	WHW-ES-Pr/CEIAF-ES/CEIAF-ES.eaf
El conductor baja hablando por un teléfono móvil.	WHW-ES-Pr/CEIAF-ES/CEIAF-ES.eaf
Se guarda el teléfono en el pantalón.	WHW-ES-Pr/CEIAF-ES/CEIAF-ES.eaf
A continuación saca del bolsillo de la camisa unas gafas de sol y se las pone.	WHW-ES-Pr/CEIAF-ES/CEIAF-ES.eaf
Sobreimpreso: JAMES, el empresario.	WHW-ES-Pr/CEIAF-ES/CEIAF-ES.eaf
Poco después, deambula con una bolsa de playa al hombro.	WHW-ES-Pr/CEIAF-ES/CEIAF-ES.eaf
Minutos más tarde, en la playa, James se tumba sobre una toalla con el torso desnudo.	WHW-ES-Pr/CEIAF-ES/CEIAF-ES.eaf
Cierra los ojos y se lleva las manos a la cara	WHW-ES-Pr/CEIAF-ES/CEIAF-ES.eaf
Luego extiende los brazos palpando suavemente la arena.	WHW-ES-Pr/CEIAF-ES/CEIAF-ES.eaf
Se recuesta y coge el teléfono móvil.	WHW-ES-Pr/CEIAF-ES/CEIAF-ES.eaf
James mira inquieto a su alrededor.	WHW-ES-Pr/CEIAF-ES/CEIAF-ES.eaf
Suelta el teléfono móvil en la toalla y se incorpora	WHW-ES-Pr/CEIAF-ES/CEIAF-ES.eaf
Camina descalzo por la orilla, mirando a su alrededor.	WHW-ES-Pr/CEIAF-ES/CEIAF-ES.eaf
La playa está totalmente desierta	WHW-ES-Pr/CEIAF-ES/CEIAF-ES.eaf
Se aproxima a la orilla, mostrando cierto recelo.	WHW-ES-Pr/CEIAF-ES/CEIAF-ES.eaf
Es un hombre rubio con barba, de estatura media y complexión fuerte.	WHW-ES-Pr/CEIAF-ES/CEIAF-ES.eaf
El extraño sonido que percibe lo mantiene alerta.	WHW-ES-Pr/CEIAF-ES/CEIAF-ES.eaf
Regresa adonde tiene la toalla. Comienza a ponerse la camisa sin dejar de mirar alrededor.	WHW-ES-Pr/CEIAF-ES/CEIAF-ES.eaf
Ya vestido, avanza solo por una arboleda.	WHW-ES-Pr/CEIAF-ES/CEIAF-ES.eaf
Continúa la marcha subiendo por una ladera salpicada de arbustos.	WHW-ES-Pr/CEIAF-ES/CEIAF-ES.eaf
En otro lugar, un hombre con barba cana y el pelo alborotado descansa con un vaso de plástico entre las manos.	WHW-ES-Pr/CEIAF-ES/CEIAF-ES.eaf
Lleva una cadena plateada al cuello y viste una camiseta verde de tirantes.	WHW-ES-Pr/CEIAF-ES/CEIAF-ES.eaf
Se distrae pasando un dedo sobre la tapa que cubre el envase. Lo abre y se lleva la bebida a los labios.	WHW-ES-Pr/CEIAF-ES/CEIAF-ES.eaf
Prueba un poco.	WHW-ES-Pr/CEIAF-ES/CEIAF-ES.eaf
Sobreimpreso: RICK, el jubilado. Su atuendo lo completan un pantalón vaquero y unas zapatillas deportivas. Rick está sentado solo en un banco de un parque, tomando café y moviendo con nerviosismo una pierna.	WHW-ES-Pr/CEIAF-ES/CEIAF-ES.eaf
Saca de un bolsillo del pantalón un teléfono móvil. Desliza un dedo por la pantalla, revisando la lista de contactos.	WHW-ES-Pr/CEIAF-ES/CEIAF-ES.eaf
Selecciona uno y marca llamada.	WHW-ES-Pr/CEIAF-ES/CEIAF-ES.eaf
Rick alza la mirada al notar algo extraño.	WHW-ES-Pr/CEIAF-ES/CEIAF-ES.eaf
Percibe el extraño sonido.	WHW-ES-Pr/CEIAF-ES/CEIAF-ES.eaf
Rick se levanta y comienza a alejarse del parque, intentando localizar el sonido.	WHW-ES-Pr/CEIAF-ES/CEIAF-ES.eaf
Ha dejado el vaso de plástico sobre uno de los bancos. Mientras, en una habitación.	WHW-ES-Pr/CEIAF-ES/CEIAF-ES.eaf
Sobreimpreso: JESS, la estudiante. Es una adolescente con el pelo rizado.	WHW-ES-Pr/CEIAF-ES/CEIAF-ES.eaf
Busca el teléfono móvil bajo un montón de papeles que tiene sobre la mesa.	WHW-ES-Pr/CEIAF-ES/CEIAF-ES.eaf
Jess también percibe el extraño sonido en la habitación donde está estudiando.	WHW-ES-Pr/CEIAF-ES/CEIAF-ES.eaf
Se levanta y se marcha. Segundos después, deambula por una zona boscosa percibiendo con mayor intensidad el extraño sonido. Se detiene un instante al llegar a una elevación.	WHW-ES-Pr/CEIAF-ES/CEIAF-ES.eaf
Continúa caminando hacia una pradera donde se encuentran Rick y James.	WHW-ES-Pr/CEIAF-ES/CEIAF-ES.eaf
Los tres miran con perplejidad a su alrededor, sin reparar en la presencia de los demás.	WHW-ES-Pr/CEIAF-ES/CEIAF-ES.eaf
La chica y los dos hombres tratan de localizar con la mirada el lugar de donde procede la voz.	WHW-ES-Pr/CEIAF-ES/CEIAF-ES.eaf
El jubilado niega con la cabeza mirando al empresario y a la estudiante, que reaccionan de igual modo.	WHW-ES-Pr/CEIAF-ES/CEIAF-ES.eaf
Rick abre los brazos y sonríe.	WHW-ES-Pr/CEIAF-ES/CEIAF-ES.eaf
El empresario y el jubilado se marchan del lugar mientras la estudiante se muestra pensativa.	WHW-ES-Pr/CEIAF-ES/CEIAF-ES.eaf
Corre unos metros hasta darles alcance.	WHW-ES-Pr/CEIAF-ES/CEIAF-ES.eaf
Los tres se marchan juntos del paraje.	WHW-ES-Pr/CEIAF-ES/CEIAF-ES.eaf
En otro momento, una mujer negra habla por un teléfono móvil mientras tiende ropa en una azotea.	WHW-ES-Pr/CEIAF-ES/CEIAF-ES.eaf
No, no he terminado de tenderla. Tengo que darme prisa.	WHW-ES-Pr/CEIAF-ES/CEIAF-ES.eaf
No, ¿de qué hablas? Sí, claro, las maletas están a punto.	WHW-ES-Pr/CEIAF-ES/CEIAF-ES.eaf
Oye, ahora no puedo hablar. Tengo que dejarte.	WHW-ES-Pr/CEIAF-ES/CEIAF-ES.eaf
Sobreimpreso: ZOÉ, la próxima.	WHW-ES-Pr/CEIAF-ES/CEIAF-ES.eaf
¿QUÉ OCURRE MIENTRAS.?	WHW-ES-Pr/CEIAF-ES/CEIAF-ES.eaf
De día. Frente a un paseo marítimo... El cielo, luminoso, está cubierto de nubes blancas. Un hombre hace "footing". Una pareja pasea con un gran perro. Sobre fondo blanco.	WHW-ES-Pr/NavarradeCine-ES/NavarradeCine-ES.eaf
Un coche blanco, de gama alta, se detiene frente al paseo marítimo.	WHW-ES-Pr/NavarradeCine-ES/NavarradeCine-ES.eaf
El conductor se baja con un maletín, mientras habla con su móvil.	WHW-ES-Pr/NavarradeCine-ES/NavarradeCine-ES.eaf
Abre el maletero.	WHW-ES-Pr/NavarradeCine-ES/NavarradeCine-ES.eaf
Cuelga. Ha dejado el maletín y ha cogido una bolsa de playa. Se pone unas gafas de sol.	WHW-ES-Pr/NavarradeCine-ES/NavarradeCine-ES.eaf
Sobreimpreso: James el empresario	WHW-ES-Pr/NavarradeCine-ES/NavarradeCine-ES.eaf
Llama con su móvil.	WHW-ES-Pr/NavarradeCine-ES/NavarradeCine-ES.eaf
Se ha quitado el traje y solo lleva un bañador. Se tumba sobre una toalla en la arena.	WHW-ES-Pr/NavarradeCine-ES/NavarradeCine-ES.eaf
Se lleva las manos a los ojos... con gesto cansado...	WHW-ES-Pr/NavarradeCine-ES/NavarradeCine-ES.eaf
Se incorpora y contesta 00:02:22	WHW-ES-Pr/NavarradeCine-ES/NavarradeCine-ES.eaf
Mira a su alrededor.	WHW-ES-Pr/NavarradeCine-ES/NavarradeCine-ES.eaf
Se levanta... y camina por la arena. Está sólo en la playa. James tiene unos 40 años, cabello corto pelirrojo y barba, también corta, del mismo color.	WHW-ES-Pr/NavarradeCine-ES/NavarradeCine-ES.eaf
Extrañado, mira en todas direcciones buscando el origen del enigmático sonido.	WHW-ES-Pr/NavarradeCine-ES/NavarradeCine-ES.eaf
Se aproxima hacia la orilla... gira... y regresa hacia sus pertenencias... Coge su ropa y vuelve a vestirse con su traje, ahora sin corbata.	WHW-ES-Pr/NavarradeCine-ES/NavarradeCine-ES.eaf
Camina bajo una arboleda.	WHW-ES-Pr/NavarradeCine-ES/NavarradeCine-ES.eaf
Sube por un camino de tierra hacia lo alto de un pequeño monte.	WHW-ES-Pr/NavarradeCine-ES/NavarradeCine-ES.eaf
En otro lugar, un hombre de unos sesenta años está sentado con un vaso entre las manos.	WHW-ES-Pr/NavarradeCine-ES/NavarradeCine-ES.eaf
Mira al cielo... y esboza una sonrisa.	WHW-ES-Pr/NavarradeCine-ES/NavarradeCine-ES.eaf
Con gesto pensativo, mira el vaso, abre la tapa que lo cubre...	WHW-ES-Pr/NavarradeCine-ES/NavarradeCine-ES.eaf
... y da un pequeño sorbo de café.	WHW-ES-Pr/NavarradeCine-ES/NavarradeCine-ES.eaf
Tiene el cabello largo, canoso y despeinado. Luce barba del mismo color y grandes ojeras. Su aspecto general es bastante desaliñado. Viste pantalones azules y camiseta de tirantes verde. Está sentado en un parque público.	WHW-ES-Pr/NavarradeCine-ES/NavarradeCine-ES.eaf
Saca su teléfono móvil... y busca un nombre entre los contactos del mismo.	WHW-ES-Pr/NavarradeCine-ES/NavarradeCine-ES.eaf
Llama a Craig Anderson.	WHW-ES-Pr/NavarradeCine-ES/NavarradeCine-ES.eaf
Alza la vista.	WHW-ES-Pr/NavarradeCine-ES/NavarradeCine-ES.eaf
Cuelga... Se levanta, deja el café sobre el banco y comienza a caminar.	WHW-ES-Pr/NavarradeCine-ES/NavarradeCine-ES.eaf
En una casa. Una joven de unos 20 años, luce melena pelirroja, larga y rizada. Sentada frente a un portátil.	WHW-ES-Pr/NavarradeCine-ES/NavarradeCine-ES.eaf
Sobreimpreso: JESS, LA ESTUDIANTE.	WHW-ES-Pr/NavarradeCine-ES/NavarradeCine-ES.eaf
Rebusca sobre la mesa.	WHW-ES-Pr/NavarradeCine-ES/NavarradeCine-ES.eaf
Contesta a su móvil.	WHW-ES-Pr/NavarradeCine-ES/NavarradeCine-ES.eaf
Cuelga y mira sorprendida hacia las paredes.	WHW-ES-Pr/NavarradeCine-ES/NavarradeCine-ES.eaf
Se levanta...	WHW-ES-Pr/NavarradeCine-ES/NavarradeCine-ES.eaf
...y sale de la casa... Camina entre maleza subiendo hacia lo alto del pequeño monte.	WHW-ES-Pr/NavarradeCine-ES/NavarradeCine-ES.eaf
Llega hasta una gran explanada.	WHW-ES-Pr/NavarradeCine-ES/NavarradeCine-ES.eaf
Los otros dos hombres ya están allí... Todos miran hacia el cielo desconcertados.	WHW-ES-Pr/NavarradeCine-ES/NavarradeCine-ES.eaf
Los tres siguen mirando extrañados.	WHW-ES-Pr/NavarradeCine-ES/NavarradeCine-ES.eaf
Los tres se miran entre sí, negando con la cabeza.	WHW-ES-Pr/NavarradeCine-ES/NavarradeCine-ES.eaf
Rick sigue a James... Jess sonríe pensativa... y va tras ellos.	WHW-ES-Pr/NavarradeCine-ES/NavarradeCine-ES.eaf
Los tres juntos caminando se alejan de la explanada... La imagen corta a negro.	WHW-ES-Pr/NavarradeCine-ES/NavarradeCine-ES.eaf
En una terraza. Una mujer de unos 30 años de raza negra tiende la ropa mientras habla por móvil.	WHW-ES-Pr/NavarradeCine-ES/NavarradeCine-ES.eaf
"NO, NO HE TERMINADO DE TENDERLA. TENGO QUE DARME PRISA." 	WHW-ES-Pr/NavarradeCine-ES/NavarradeCine-ES.eaf
"NO, ¿DE QUÉ ME HABLAS? SÍ, CLARO. LAS MALETAS ESTÁN A PUNTO..." 	WHW-ES-Pr/NavarradeCine-ES/NavarradeCine-ES.eaf
"OYE, AHORA NO PUEDO HABLAR. TENGO QUE DEJARTE." 	WHW-ES-Pr/NavarradeCine-ES/NavarradeCine-ES.eaf
Sobreimpreso: ZOÉ, LA PRÓXIMA.	WHW-ES-Pr/NavarradeCine-ES/NavarradeCine-ES.eaf
La imagen se congela. Sobre fondo blanco: 	WHW-ES-Pr/NavarradeCine-ES/NavarradeCine-ES.eaf
¿QUÉ PASA MIENTRAS...?	WHW-ES-Pr/NavarradeCine-ES/NavarradeCine-ES.eaf
Amanece un día fresco y nublado en la playa. Una persona hace footing mientras una pareja pasea a su perro.	WHW-ES-Pr/EdSolProducciones-ES/EdSolProducciones-ES.eaf
En  la misma playa un ejecutivo de mediana edad, con traje y corbata, aparca su choche de alta gama mientras habla por el móvil.	WHW-ES-Pr/EdSolProducciones-ES/EdSolProducciones-ES.eaf
Cambia el maletín por una bolsa de playa.	WHW-ES-Pr/EdSolProducciones-ES/EdSolProducciones-ES.eaf
Cuelga el móvil con gesto de desagrado. 	WHW-ES-Pr/EdSolProducciones-ES/EdSolProducciones-ES.eaf
Saca las gafas de sol del bolsillo de su chaqueta y mientras se las pone trata de serenarse.	WHW-ES-Pr/EdSolProducciones-ES/EdSolProducciones-ES.eaf
James, el empresario.	WHW-ES-Pr/EdSolProducciones-ES/EdSolProducciones-ES.eaf
Camina por el acceso a la playa con su bolsa colgada mientras habla por el móvil.	WHW-ES-Pr/EdSolProducciones-ES/EdSolProducciones-ES.eaf
Ya en la playa, despojado de su traje y en bañador, James  se tumba sobre su toalla mientras trata de relajarse.	WHW-ES-Pr/EdSolProducciones-ES/EdSolProducciones-ES.eaf
Se incorpora, con gesto incómodo, para atender la llamada.	WHW-ES-Pr/EdSolProducciones-ES/EdSolProducciones-ES.eaf
Gira la cabeza al oír un ruido desconocido.	WHW-ES-Pr/EdSolProducciones-ES/EdSolProducciones-ES.eaf
Extrañado, trata de localizar el origen del sonido agudo que le perturba.	WHW-ES-Pr/EdSolProducciones-ES/EdSolProducciones-ES.eaf
Se pone en pie y camina por la playa intentando localizar la procedencia del sonido.	WHW-ES-Pr/EdSolProducciones-ES/EdSolProducciones-ES.eaf
Habiendo encontrado la dirección desde donde parece que se produce el sonido, decide vestirse para llegar hasta su origen.	WHW-ES-Pr/EdSolProducciones-ES/EdSolProducciones-ES.eaf
Ya alejado de la playa, con el traje y sin la corbata va siguiendo a pie el sonido perturbador que le dirige hacia un monte cercano.	WHW-ES-Pr/EdSolProducciones-ES/EdSolProducciones-ES.eaf
En un parque de la ciudad, un personaje masculino de mayor edad que el anterior, con barba y pelo canoso, camiseta de tirantes y aspecto descuidado sujeta un vaso de plástico entre sus manos.	WHW-ES-Pr/EdSolProducciones-ES/EdSolProducciones-ES.eaf
Destapa el vaso de café y le da un trago sin mucha gana.	WHW-ES-Pr/EdSolProducciones-ES/EdSolProducciones-ES.eaf
Rick, el jubilado.	WHW-ES-Pr/EdSolProducciones-ES/EdSolProducciones-ES.eaf
Mientras Rick está bebiendo su café sentado en un banco del parque, inconscientemente mueve su pierna derecha de forma repetitiva, mostrando su inquietud.	WHW-ES-Pr/EdSolProducciones-ES/EdSolProducciones-ES.eaf
Posa el vaso de café en el banco de al lado, 	WHW-ES-Pr/EdSolProducciones-ES/EdSolProducciones-ES.eaf
saca el móvil del bolsillo,	WHW-ES-Pr/EdSolProducciones-ES/EdSolProducciones-ES.eaf
busca entre sus contactos,	WHW-ES-Pr/EdSolProducciones-ES/EdSolProducciones-ES.eaf
y hace una llamada.	WHW-ES-Pr/EdSolProducciones-ES/EdSolProducciones-ES.eaf
Gira la cabeza al oír un ruido desconocido.	WHW-ES-Pr/EdSolProducciones-ES/EdSolProducciones-ES.eaf
Intenta localizar el sonido perturbador.	WHW-ES-Pr/EdSolProducciones-ES/EdSolProducciones-ES.eaf
Se pone en pie y camina para localizar el sonido. 	WHW-ES-Pr/EdSolProducciones-ES/EdSolProducciones-ES.eaf
En otro lugar, una joven de pelo rizado está sentada en su escritorio delante de un ordenador portátil.	WHW-ES-Pr/EdSolProducciones-ES/EdSolProducciones-ES.eaf
Jess, la estudiante.	WHW-ES-Pr/EdSolProducciones-ES/EdSolProducciones-ES.eaf
Busca el móvil entre sus apuntes.	WHW-ES-Pr/EdSolProducciones-ES/EdSolProducciones-ES.eaf
Gira la cabeza para  localizar el sonido.	WHW-ES-Pr/EdSolProducciones-ES/EdSolProducciones-ES.eaf
Preocupada, mira a ambos lados.	WHW-ES-Pr/EdSolProducciones-ES/EdSolProducciones-ES.eaf
Se pone en pie y sale al exterior en busca del origen del sonido perturbador.	WHW-ES-Pr/EdSolProducciones-ES/EdSolProducciones-ES.eaf
Se interna en el monte y avanza hacia la dirección del sonido.	WHW-ES-Pr/EdSolProducciones-ES/EdSolProducciones-ES.eaf
El sonido ha guiado a los tres protagonistas hacia un claro del monte.	WHW-ES-Pr/EdSolProducciones-ES/EdSolProducciones-ES.eaf
Desde direcciones han llegado andando hasta un mismo punto.	WHW-ES-Pr/EdSolProducciones-ES/EdSolProducciones-ES.eaf
Están desorientados y extrañados.	WHW-ES-Pr/EdSolProducciones-ES/EdSolProducciones-ES.eaf
Los tres miran en todas direcciones intentando localizar quien les habla.	WHW-ES-Pr/EdSolProducciones-ES/EdSolProducciones-ES.eaf
Se miran entre sí.	WHW-ES-Pr/EdSolProducciones-ES/EdSolProducciones-ES.eaf
James y Rick comienzan a andar de vuelta  hacia el monte,	WHW-ES-Pr/EdSolProducciones-ES/EdSolProducciones-ES.eaf
Jess duda por un segundo, sonríe y se une a ellos en una breve carrera.	WHW-ES-Pr/EdSolProducciones-ES/EdSolProducciones-ES.eaf
Los tres juntos caminan alegres de nuevo hacia el monte en dirección a la playa.	WHW-ES-Pr/EdSolProducciones-ES/EdSolProducciones-ES.eaf
En otro lugar, una mujer de color habla por el móvil mientras tiende la colada en la azotea. No, no he terminado de tenderla. Tengo que darme prisa. Gira la cabeza ante un ruido desconocido.	WHW-ES-Pr/EdSolProducciones-ES/EdSolProducciones-ES.eaf
No, de qué me hablas? Si claro, las maletas están a punto…. Extrañada trata de localizar el sonido perturbador Oye, ahora no puedo hablar. Tengo que dejarte.	WHW-ES-Pr/EdSolProducciones-ES/EdSolProducciones-ES.eaf
Zoé, la próxima	WHW-ES-Pr/EdSolProducciones-ES/EdSolProducciones-ES.eaf
Qué pasa mientras…	WHW-ES-Pr/EdSolProducciones-ES/EdSolProducciones-ES.eaf
Una pareja camina junto a su perro por un paseo marítimo. Se cruzan con un hombre que hace footing. Todos visten ropa de abrigo. La playa está desierta y el cielo cubierto de nubes grises.	WHW-ES-Pr/Ericsson-ES/Ericsson-ES.eaf
Un automóvil tipo coupé se detiene junto a la acera.	WHW-ES-Pr/Ericsson-ES/Ericsson-ES.eaf
Dentro, un hombre de unos 45 años gesticula hablando por el móvil.	WHW-ES-Pr/Ericsson-ES/Ericsson-ES.eaf
Tras sacar una bolsa del maletero, echa un vistazo a la playa y se coloca unas gafas de sol. Viste un elegante traje de chaqueta. Lleva el primer botón de la camisa desabrochado y la corbata floja.	WHW-ES-Pr/Ericsson-ES/Ericsson-ES.eaf
Es James, el empresario. Minutos después, camina con la bolsa de playa al hombro mientras hace una llamada.	WHW-ES-Pr/Ericsson-ES/Ericsson-ES.eaf
Poco después, con el torso desnudo, se deja caer pesadamente sobre una toalla extendida en la arena.	WHW-ES-Pr/Ericsson-ES/Ericsson-ES.eaf
James, rubio y de piel clara, luce una barba recortada que empieza a poblarse de canas. Extiende los brazos y acaricia la arena con la yema de los dedos.	WHW-ES-Pr/Ericsson-ES/Ericsson-ES.eaf
Se incorpora de mala gana.	WHW-ES-Pr/Ericsson-ES/Ericsson-ES.eaf
Mira a su alrededor extrañado.	WHW-ES-Pr/Ericsson-ES/Ericsson-ES.eaf
Se incorpora y se aleja unos metros examinando los alrededores. 	WHW-ES-Pr/Ericsson-ES/Ericsson-ES.eaf
Viste unos calzoncillos tipo bóxer, el resto de su ropa está amontonada sobre la arena. 	WHW-ES-Pr/Ericsson-ES/Ericsson-ES.eaf
Confuso, decide volver sobre sus pasos	WHW-ES-Pr/Ericsson-ES/Ericsson-ES.eaf
Se detiene y vuelve a mirar intrigado a su alrededor.	WHW-ES-Pr/Ericsson-ES/Ericsson-ES.eaf
Cada vez más inquieto,  se dirige hacia sus pertenencias.	WHW-ES-Pr/Ericsson-ES/Ericsson-ES.eaf
Recoge la camisa del suelo y se la pone sin dejar de escudriñar el entorno. 	WHW-ES-Pr/Ericsson-ES/Ericsson-ES.eaf
Minutos después, camina decidido bajo unos árboles. 	WHW-ES-Pr/Ericsson-ES/Ericsson-ES.eaf
Luego, sube por un escarpado sendero entre la maleza. 	WHW-ES-Pr/Ericsson-ES/Ericsson-ES.eaf
En un banco de un parque, con un vaso desechable entre las manos, un hombre de unos 65 años se agita disgustado. Sonríe levemente alzando la vista.	WHW-ES-Pr/Ericsson-ES/Ericsson-ES.eaf
Niega con la cabeza mientras juguetea con la tapa del vaso. 	WHW-ES-Pr/Ericsson-ES/Ericsson-ES.eaf
Echa un vistazo al líquido oscuro del interior y toma un sorbo. Tiene el pelo descuidado y canoso, barba de varios días y viste camiseta de tirantes.	WHW-ES-Pr/Ericsson-ES/Ericsson-ES.eaf
Es Rick, el jubilado. 	WHW-ES-Pr/Ericsson-ES/Ericsson-ES.eaf
Junto a él hay dos bancos vacíos. Rick, inquieto, agita su pierna sin parar.	WHW-ES-Pr/Ericsson-ES/Ericsson-ES.eaf
Suelta el vaso y da unas palmadas dejándose caer sobre el respaldo del banco.	WHW-ES-Pr/Ericsson-ES/Ericsson-ES.eaf
Hastiado, saca un Smartphone del bolsillo, lo abre y revisa la lista de contactos.	WHW-ES-Pr/Ericsson-ES/Ericsson-ES.eaf
Se detiene en Craig Anderson y pulsa llamada.	WHW-ES-Pr/Ericsson-ES/Ericsson-ES.eaf
Alza la mirada confundido.	WHW-ES-Pr/Ericsson-ES/Ericsson-ES.eaf
Se aleja entusiasmado sin dejar de buscar con la mirada alrededor de sí. Ha dejado el vaso sobre el banco.	WHW-ES-Pr/Ericsson-ES/Ericsson-ES.eaf
En una habitación, una joven de unos 20 años, de abundante melena pelirroja, trata de concentrarse frente a un portátil.	WHW-ES-Pr/Ericsson-ES/Ericsson-ES.eaf
Es Jess, la estudiante.	WHW-ES-Pr/Ericsson-ES/Ericsson-ES.eaf
Rebusca entre las cosas del escritorio 	WHW-ES-Pr/Ericsson-ES/Ericsson-ES.eaf
Al fin, encuentra su teléfono móvil.	WHW-ES-Pr/Ericsson-ES/Ericsson-ES.eaf
La joven, que removía nerviosa los papeles de su mesa, se detiene y mira a su alrededor. 	WHW-ES-Pr/Ericsson-ES/Ericsson-ES.eaf
Intrigada, se levanta y sale a la calle.	WHW-ES-Pr/Ericsson-ES/Ericsson-ES.eaf
Lleva un abrigo y un pañuelo en el cuello. Camina decidida y se adentra en una zona de abundante vegetación.	WHW-ES-Pr/Ericsson-ES/Ericsson-ES.eaf
Al poco, llega a una amplia y soleada explanada donde están James y Rick.	WHW-ES-Pr/Ericsson-ES/Ericsson-ES.eaf
Los hombres están de pie, mirando desconcertados a su alrededor.	WHW-ES-Pr/Ericsson-ES/Ericsson-ES.eaf
La chica se dirige hacia ellos.	WHW-ES-Pr/Ericsson-ES/Ericsson-ES.eaf
Extrañados, tratan de localizar la procedencia de la voz.	WHW-ES-Pr/Ericsson-ES/Ericsson-ES.eaf
Se miran y niegan con la cabeza.	WHW-ES-Pr/Ericsson-ES/Ericsson-ES.eaf
Jessica, pensativa, se ha quedado inmóvil.	WHW-ES-Pr/Ericsson-ES/Ericsson-ES.eaf
Corre tras ellos.	WHW-ES-Pr/Ericsson-ES/Ericsson-ES.eaf
James echa el brazo por el hombro de la chica y los tres se alejan satisfechos del descampado.	WHW-ES-Pr/Ericsson-ES/Ericsson-ES.eaf
En una azotea, una mujer de mediana edad tiende la colada mientras habla por el móvil. Dice que tiene que darse prisa y que las maletas están a punto.	WHW-ES-Pr/Ericsson-ES/Ericsson-ES.eaf
Confusa, dice que no puede hablar y corta la llamada.	WHW-ES-Pr/Ericsson-ES/Ericsson-ES.eaf
Es Zoé, la próxima.	WHW-ES-Pr/Ericsson-ES/Ericsson-ES.eaf
What happens while…	WHW-ES-Pr/Ericsson-ES/Ericsson-ES.eaf
Audiodescripción Kaleidoscope 2016. Amanece en un paseo marítimo con la playa al fondo. Una pareja pasea con un perro. Un hombre hace footing.	WHW-ES-Pr/Kaleidoscope-ES/Kaleidoscope-ES.eaf
Sobre fondo blanco.	WHW-ES-Pr/Kaleidoscope-ES/Kaleidoscope-ES.eaf
Un hombre trajeado y con corbata aparca un coche deportivo blanco y sale hablando por teléfono.	WHW-ES-Pr/Kaleidoscope-ES/Kaleidoscope-ES.eaf
Cuelga. Guardó un maletín y sacó una bolsa de rayas del maletero. Mira la playa, suspira y se pone unas gafas de sol.	WHW-ES-Pr/Kaleidoscope-ES/Kaleidoscope-ES.eaf
James, el empresario.	WHW-ES-Pr/Kaleidoscope-ES/Kaleidoscope-ES.eaf
Camina por el paseo llamando por el móvil.	WHW-ES-Pr/Kaleidoscope-ES/Kaleidoscope-ES.eaf
Después, sin ropa, se tumba sobre una toalla en la arena.	WHW-ES-Pr/Kaleidoscope-ES/Kaleidoscope-ES.eaf
Se frota los ojos y extiende sus brazos.	WHW-ES-Pr/Kaleidoscope-ES/Kaleidoscope-ES.eaf
Mira a su alrededor	WHW-ES-Pr/Kaleidoscope-ES/Kaleidoscope-ES.eaf
Cuelga y se levanta extrañado por el ruido. Camina por la orilla y la arena mirando, desconcertado, en todas direcciones.	WHW-ES-Pr/Kaleidoscope-ES/Kaleidoscope-ES.eaf
Lleva un bóxer negro. Se para y anda sobre sus propios pasos preocupado por el ruido.	WHW-ES-Pr/Kaleidoscope-ES/Kaleidoscope-ES.eaf
Comienza a vestirse.	WHW-ES-Pr/Kaleidoscope-ES/Kaleidoscope-ES.eaf
Después, vestido con el traje, pero sin la corbata, camina por una arboleda.	WHW-ES-Pr/Kaleidoscope-ES/Kaleidoscope-ES.eaf
Sube por un sendero empinado.	WHW-ES-Pr/Kaleidoscope-ES/Kaleidoscope-ES.eaf
Un hombre de pelo rizado y canoso, barba desaliñada, cadena de plata al cuello, camiseta de tirantes y tatuajes tamborilea sus dedos en un vaso de plástico.	WHW-ES-Pr/Kaleidoscope-ES/Kaleidoscope-ES.eaf
Quita la tapa al vaso y bebe café con gesto resignado.	WHW-ES-Pr/Kaleidoscope-ES/Kaleidoscope-ES.eaf
Suspira inquieto.	WHW-ES-Pr/Kaleidoscope-ES/Kaleidoscope-ES.eaf
Rick, el jubilado.	WHW-ES-Pr/Kaleidoscope-ES/Kaleidoscope-ES.eaf
Es de día. Está sentado en unos bancos individuales en un parque rodeado de árboles. Mueve una pierna intranquilo y bebe el café.	WHW-ES-Pr/Kaleidoscope-ES/Kaleidoscope-ES.eaf
Deja el vaso en un banco contiguo. Saca su smartphone y busca entre los contactos. 	WHW-ES-Pr/Kaleidoscope-ES/Kaleidoscope-ES.eaf
Llama a Craig Anderson.	WHW-ES-Pr/Kaleidoscope-ES/Kaleidoscope-ES.eaf
Mira a su alrededor.	WHW-ES-Pr/Kaleidoscope-ES/Kaleidoscope-ES.eaf
Extrañado, mira en todas direcciones.	WHW-ES-Pr/Kaleidoscope-ES/Kaleidoscope-ES.eaf
Cuelga y se aleja mirando hacia arriba y a los lados.	WHW-ES-Pr/Kaleidoscope-ES/Kaleidoscope-ES.eaf
En una habitación, una chica de pelo rizado estudia frente a un ordenador. 	WHW-ES-Pr/Kaleidoscope-ES/Kaleidoscope-ES.eaf
Jess, la estudiante.	WHW-ES-Pr/Kaleidoscope-ES/Kaleidoscope-ES.eaf
Busca el móvil entre los apuntes.	WHW-ES-Pr/Kaleidoscope-ES/Kaleidoscope-ES.eaf
Descuelga.	WHW-ES-Pr/Kaleidoscope-ES/Kaleidoscope-ES.eaf
Cuelga y mira extrañada a su alrededor.	WHW-ES-Pr/Kaleidoscope-ES/Kaleidoscope-ES.eaf
Se levanta. Después anda inquieta por la calle.	WHW-ES-Pr/Kaleidoscope-ES/Kaleidoscope-ES.eaf
Sube una pendiente rodeada de vegetación. 	WHW-ES-Pr/Kaleidoscope-ES/Kaleidoscope-ES.eaf
Se para, mira en todas direcciones y continua.	WHW-ES-Pr/Kaleidoscope-ES/Kaleidoscope-ES.eaf
Llega a un claro soleado en el que están Rick y James. Se acerca poco a poco a ellos. Todos miran en todas direcciones.	WHW-ES-Pr/Kaleidoscope-ES/Kaleidoscope-ES.eaf
Voz en off.	WHW-ES-Pr/Kaleidoscope-ES/Kaleidoscope-ES.eaf
Sorprendidos, todos miran hacia arriba y a los lados.	WHW-ES-Pr/Kaleidoscope-ES/Kaleidoscope-ES.eaf
Se encoje de hombros.	WHW-ES-Pr/Kaleidoscope-ES/Kaleidoscope-ES.eaf
Se miran. Rick y Jessica niegan.	WHW-ES-Pr/Kaleidoscope-ES/Kaleidoscope-ES.eaf
James se va, Rick le sigue. Jessica queda cabizbaja.	WHW-ES-Pr/Kaleidoscope-ES/Kaleidoscope-ES.eaf
Se une. James le pasa el brazo por el hombro, Rick le extiende su mano y los tres caminan juntos.	WHW-ES-Pr/Kaleidoscope-ES/Kaleidoscope-ES.eaf
La imagen funde a negro. Una mujer negra tiende ropa en una azotea mientras habla por el móvil.	WHW-ES-Pr/Kaleidoscope-ES/Kaleidoscope-ES.eaf
No, no he terminado de tenderla. Tengo que darme prisa.	WHW-ES-Pr/Kaleidoscope-ES/Kaleidoscope-ES.eaf
No, ¿de qué me hablas? Sí, claro, las maletas están a punto. Mira a su alrededor extrañada.Oye, ahora no puedo hablar. Tengo que dejarte. Cuelga. Zoé, la próxima. La imagen funde a negro. Sobre fondo blanco el título Qué pasa mientras.	WHW-ES-Pr/Kaleidoscope-ES/Kaleidoscope-ES.eaf
Es un día nuboso en una playa. Una pareja pasea por la arena con su perro. Por la orilla pasa un hombre haciendo footing	WHW-ES-Pr/SDI-Media-ES/SDI-Media-ES.eaf
El perro se para a olisquear algo.	WHW-ES-Pr/SDI-Media-ES/SDI-Media-ES.eaf
En animal atiende al silbido del amo y prosigue su camino.	WHW-ES-Pr/SDI-Media-ES/SDI-Media-ES.eaf
Un coche blanco circula junto al paseo marítimo. El conductor aparca mientras habla por el móvil. Se quita el cinturón y abre.	WHW-ES-Pr/SDI-Media-ES/SDI-Media-ES.eaf
Se trata de un hombre de unos cuarenta años con barba y piel clara. Viste traje de chaqueta y corbata. Cuelga el teléfono y mira hacia la playa. Saca del bolsillo unas gafas de sol y se las pone. 	WHW-ES-Pr/SDI-Media-ES/SDI-Media-ES.eaf
JAMES. EL EMPRESARIO.	WHW-ES-Pr/SDI-Media-ES/SDI-Media-ES.eaf
James camina con una bolsa de playa al hombro. Marca en su teléfono.	WHW-ES-Pr/SDI-Media-ES/SDI-Media-ES.eaf
Más tarde, en la playa, James se tumba boca arriba sobre una toalla.	WHW-ES-Pr/SDI-Media-ES/SDI-Media-ES.eaf
Tiene el torso desnudo y los ojos cerrados.  Se pasa las manos por la cara y extiende los brazos dejándolos caer a cada lado. Revuelve la arena con los dedos.	WHW-ES-Pr/SDI-Media-ES/SDI-Media-ES.eaf
Frunce el ceño y mira entre sus cosas.	WHW-ES-Pr/SDI-Media-ES/SDI-Media-ES.eaf
Suelta el teléfono y se pone en pie. 	WHW-ES-Pr/SDI-Media-ES/SDI-Media-ES.eaf
Camina hacia la orilla, está en calzoncillos. 	WHW-ES-Pr/SDI-Media-ES/SDI-Media-ES.eaf
Da algunos pasos sin rumbo mirando extrañado a su alrededor, como si buscara algo. 	WHW-ES-Pr/SDI-Media-ES/SDI-Media-ES.eaf
Queda quieto unos segundos y vuelve hacia su toalla.	WHW-ES-Pr/SDI-Media-ES/SDI-Media-ES.eaf
Se para y da media vuelta alarmado. Retoma el paso dibujando pisadas inconexas en la arena. 	WHW-ES-Pr/SDI-Media-ES/SDI-Media-ES.eaf
James vuelve hacia su toalla mirando hacia el cielo con cara de desconcierto.	WHW-ES-Pr/SDI-Media-ES/SDI-Media-ES.eaf
Coge la camisa y se la pone sin relajar el ceño.	WHW-ES-Pr/SDI-Media-ES/SDI-Media-ES.eaf
Más tarde, James ha abandonado la playa. Lleva puesto de nuevo el traje de chaqueta sin la corbata. Camina por una arboleda.	WHW-ES-Pr/SDI-Media-ES/SDI-Media-ES.eaf
Llega hasta una colina llena de arbustos y cactus. Comienza a subir por una senda de tierra.	WHW-ES-Pr/SDI-Media-ES/SDI-Media-ES.eaf
En otro lugar, alguien sostiene un vaso térmico con tapadera.	WHW-ES-Pr/SDI-Media-ES/SDI-Media-ES.eaf
Se trata de un hombre de unos sesenta años con barbas, ojos saltones y pelo largo desaliñado. Viste camiseta de tirantes y lleva una cadena de eslabones al cuello.	WHW-ES-Pr/SDI-Media-ES/SDI-Media-ES.eaf
Toquetea aburrido la tapadera del vaso	WHW-ES-Pr/SDI-Media-ES/SDI-Media-ES.eaf
La abre, está lleno de café.	WHW-ES-Pr/SDI-Media-ES/SDI-Media-ES.eaf
El hombre observa el café y bebe. 	WHW-ES-Pr/SDI-Media-ES/SDI-Media-ES.eaf
Mira hacia el frente con desencanto en sus ojos. 	WHW-ES-Pr/SDI-Media-ES/SDI-Media-ES.eaf
RICK. EL JUBILADO.	WHW-ES-Pr/SDI-Media-ES/SDI-Media-ES.eaf
Rick está sentado en un banco individual en un parque. Bebe un trago más de café mientras mueve nervioso una pierna.	WHW-ES-Pr/SDI-Media-ES/SDI-Media-ES.eaf
Deja el vaso en el banco de al lado y se recuesta en el respaldo del suyo.	WHW-ES-Pr/SDI-Media-ES/SDI-Media-ES.eaf
Saca el teléfono móvil del bolsillo trasero del pantalón y busca en la agenda de contactos.	WHW-ES-Pr/SDI-Media-ES/SDI-Media-ES.eaf
Marca GRAIG ANDERSON.	WHW-ES-Pr/SDI-Media-ES/SDI-Media-ES.eaf
Mira extrañado hacia el cielo.	WHW-ES-Pr/SDI-Media-ES/SDI-Media-ES.eaf
Rick sonríe y cuelga. Se pone en pie y se aleja del banco dejando olvidado el vaso de café.	WHW-ES-Pr/SDI-Media-ES/SDI-Media-ES.eaf
Abandona el parque dando pasos de un lado a otro y mirando hacia el cielo.	WHW-ES-Pr/SDI-Media-ES/SDI-Media-ES.eaf
En otra parte. 	WHW-ES-Pr/SDI-Media-ES/SDI-Media-ES.eaf
Una chica frente a un ordenador.	WHW-ES-Pr/SDI-Media-ES/SDI-Media-ES.eaf
JESS. LA ESTUDIANTE.	WHW-ES-Pr/SDI-Media-ES/SDI-Media-ES.eaf
Tiene el pelo rizado y rojo. 	WHW-ES-Pr/SDI-Media-ES/SDI-Media-ES.eaf
Rebusca entre unos papeles, encuentra el móvil.	WHW-ES-Pr/SDI-Media-ES/SDI-Media-ES.eaf
Se rasca el oído.	WHW-ES-Pr/SDI-Media-ES/SDI-Media-ES.eaf
Cuelga y mira de lado a lado con gesto extrañado.	WHW-ES-Pr/SDI-Media-ES/SDI-Media-ES.eaf
Se sobresalta y mira hacia el techo.	WHW-ES-Pr/SDI-Media-ES/SDI-Media-ES.eaf
Jess está en la calle. Se ha puesto el abrigo. Camina aturdida en busca de algo.	WHW-ES-Pr/SDI-Media-ES/SDI-Media-ES.eaf
Sube por un montículo lleno de arbustos y maleza. 	WHW-ES-Pr/SDI-Media-ES/SDI-Media-ES.eaf
Se para y mira desconfiada a su alrededor.	WHW-ES-Pr/SDI-Media-ES/SDI-Media-ES.eaf
Continúa y se pierde entre la vegetación.	WHW-ES-Pr/SDI-Media-ES/SDI-Media-ES.eaf
Jess llega a un descampado donde también están Rick y James. La luz del sol brilla con fuerza.	WHW-ES-Pr/SDI-Media-ES/SDI-Media-ES.eaf
Los tres miran desconcertados de lado a lado.	WHW-ES-Pr/SDI-Media-ES/SDI-Media-ES.eaf
Giran sobre sí mismos con cara de asombro y mirando hacia el cielo.	WHW-ES-Pr/SDI-Media-ES/SDI-Media-ES.eaf
Él se encoge de hombros.	WHW-ES-Pr/SDI-Media-ES/SDI-Media-ES.eaf
Rick niega con la cabeza, Jess también. 	WHW-ES-Pr/SDI-Media-ES/SDI-Media-ES.eaf
Rick alza los brazos.	WHW-ES-Pr/SDI-Media-ES/SDI-Media-ES.eaf
James camina hacia los arbustos, Rick le sigue. Jess queda pensativa.	WHW-ES-Pr/SDI-Media-ES/SDI-Media-ES.eaf
Corre hacia ellos y James le rodea los hombros con el brazo. Los tres caminan hacia el bosque de matorrales y abandonan el descampado.	WHW-ES-Pr/SDI-Media-ES/SDI-Media-ES.eaf
Fundido a negro. Una mujer tiende la ropa mientras habla por teléfono.	WHW-ES-Pr/SDI-Media-ES/SDI-Media-ES.eaf
En subtítulos. No, no he terminado de tenderla. Tengo que darme prisa.	WHW-ES-Pr/SDI-Media-ES/SDI-Media-ES.eaf
No, ¿de qué me hablas? Sí, claro las maletas están a punto...	WHW-ES-Pr/SDI-Media-ES/SDI-Media-ES.eaf
Se gira con gesto confuso.	WHW-ES-Pr/SDI-Media-ES/SDI-Media-ES.eaf
Oye, ahora no puedo hablar. Tengo que dejarte.	WHW-ES-Pr/SDI-Media-ES/SDI-Media-ES.eaf
Cuelga y frunce el ceño.	WHW-ES-Pr/SDI-Media-ES/SDI-Media-ES.eaf
ZOé. LA PRÓXIMA.	WHW-ES-Pr/SDI-Media-ES/SDI-Media-ES.eaf
Fundido a negro. Sobre un fondo blanco surge el rótulo: ¿QUé PASA MIENTRAS…?	WHW-ES-Pr/SDI-Media-ES/SDI-Media-ES.eaf
En una playa casi vacía una pareja pasea un perro y un hombre hace footing. La pareja lleva ropa de abrigo y el cielo está nublado.	WHW-ES-Pr/Sonidos-ES/Sonidos-ES.eaf
Sobreescrito en pantalla.	WHW-ES-Pr/Sonidos-ES/Sonidos-ES.eaf
Un coche de alta gama aparca frente a la playa. Un hombre trajeado se baja, abre el maletero y cambia su maletín por una bolsa de playa.	WHW-ES-Pr/Sonidos-ES/Sonidos-ES.eaf
El hombre, de unos cincuenta años y con barba, saca unas gafas de sol del bolsillo de su chaqueta y se las pone.	WHW-ES-Pr/Sonidos-ES/Sonidos-ES.eaf
Sobreescrito en pantalla: JAMES. EL EMPRESARIO.	WHW-ES-Pr/Sonidos-ES/Sonidos-ES.eaf
James camina con la bolsa de playa al hombro y llama.	WHW-ES-Pr/Sonidos-ES/Sonidos-ES.eaf
Sobre la arena, el traje oscuro de James reposa hecho un revoltillo.	WHW-ES-Pr/Sonidos-ES/Sonidos-ES.eaf
James se tumba a su lado, boca arriba, y se queda tendido. Después se frota los ojos, abre los brazos y juguetea con la arena.	WHW-ES-Pr/Sonidos-ES/Sonidos-ES.eaf
Mira extrañado a su alrededor	WHW-ES-Pr/Sonidos-ES/Sonidos-ES.eaf
Deja el móvil, se levanta y camina hasta el agua mirando al rededor. Sólo lleva los slips.	WHW-ES-Pr/Sonidos-ES/Sonidos-ES.eaf
Camina sin rumbo fijo, titubeando.	WHW-ES-Pr/Sonidos-ES/Sonidos-ES.eaf
Se da la vuelta, se para un momento y otea con los ojos entornados y frunciendo el ceño.	WHW-ES-Pr/Sonidos-ES/Sonidos-ES.eaf
Camina hacia el agua mirando alrededor y después vuelve a su ropa.	WHW-ES-Pr/Sonidos-ES/Sonidos-ES.eaf
Se pone la camisa sin dejar de mirar al rededor.	WHW-ES-Pr/Sonidos-ES/Sonidos-ES.eaf
Por una calle flanqueada por grandes árboles, James camina ya vestido.	WHW-ES-Pr/Sonidos-ES/Sonidos-ES.eaf
Más tarde asciende por un sendero entre matorrales la ladera de un monte.	WHW-ES-Pr/Sonidos-ES/Sonidos-ES.eaf
Unas manos sostienen un vaso de plástico blanco	WHW-ES-Pr/Sonidos-ES/Sonidos-ES.eaf
Un hombre de unos sesenta años, con pelo desaliñado y barba canosa mira a su alrededor desde el banco de un parque.	WHW-ES-Pr/Sonidos-ES/Sonidos-ES.eaf
Acaricia la tapa del vaso de plástico.	WHW-ES-Pr/Sonidos-ES/Sonidos-ES.eaf
Lo abre y bebe un trago. Tiene tatuajes, collar y pulsera.	WHW-ES-Pr/Sonidos-ES/Sonidos-ES.eaf
Sobreescrito en pantalla: RICK. EL JUBILADO.	WHW-ES-Pr/Sonidos-ES/Sonidos-ES.eaf
Rick deja la tapa en el banco de al lado. Está sentado. Lleva una camiseta verde de tirantes por dentro del pantalón y mueve sin parar la pierna derecha.	WHW-ES-Pr/Sonidos-ES/Sonidos-ES.eaf
Saca el móvil del bolsillo trasero de su pantalón y busca entre sus contactos.	WHW-ES-Pr/Sonidos-ES/Sonidos-ES.eaf
Selecciona a Craig  Anderson. Llama.	WHW-ES-Pr/Sonidos-ES/Sonidos-ES.eaf
Mira al rededor	WHW-ES-Pr/Sonidos-ES/Sonidos-ES.eaf
Mira hacia arriba	WHW-ES-Pr/Sonidos-ES/Sonidos-ES.eaf
El vaso queda sobre el banco y Rick se aleja, sin dejar de mirar hacia arriba y a los lados.	WHW-ES-Pr/Sonidos-ES/Sonidos-ES.eaf
Una adolescente muerde un lápiz.	WHW-ES-Pr/Sonidos-ES/Sonidos-ES.eaf
Sobreescrito en pantalla. JESS. LA ESTUDIANTE.	WHW-ES-Pr/Sonidos-ES/Sonidos-ES.eaf
Rebusca por su mesa, entre papeles y su ordenador.	WHW-ES-Pr/Sonidos-ES/Sonidos-ES.eaf
Jess mira hacia el techo y las paredes. Tiene larga melena pelirroja y rizada.	WHW-ES-Pr/Sonidos-ES/Sonidos-ES.eaf
De día, asciende por una ladera entre hierbas y arbustos. Lleva abrigo y cada poco se para y mira alrededor. Luego sale corriendo.	WHW-ES-Pr/Sonidos-ES/Sonidos-ES.eaf
En una explanada, James, Rick y Jess miran alrededor. Rick y James están frente a frente, Jess está detrás de  Rick.	WHW-ES-Pr/Sonidos-ES/Sonidos-ES.eaf
Miran a su alrededor, James usa la mano como visera.	WHW-ES-Pr/Sonidos-ES/Sonidos-ES.eaf
Se miran entre ellos. Rick y Jess niegan.	WHW-ES-Pr/Sonidos-ES/Sonidos-ES.eaf
Rick sigue a James, Jess se queda parada y levanta una ceja	WHW-ES-Pr/Sonidos-ES/Sonidos-ES.eaf
Corre tras ellos, se sitúa entre los dos y James le pone una mano en el hombro.	WHW-ES-Pr/Sonidos-ES/Sonidos-ES.eaf
Los tres se alejan caminando.	WHW-ES-Pr/Sonidos-ES/Sonidos-ES.eaf
Una mujer tiende la ropa mientras habla por el móvil.	WHW-ES-Pr/Sonidos-ES/Sonidos-ES.eaf
No, no he terminado de tenderla. Tengo que darme prisa.	WHW-ES-Pr/Sonidos-ES/Sonidos-ES.eaf
No, ¿de qué me hablas? Si, claro, las maletas están a punto...	WHW-ES-Pr/Sonidos-ES/Sonidos-ES.eaf
Mira a su alrededor	WHW-ES-Pr/Sonidos-ES/Sonidos-ES.eaf
Oye no puedo hablar. Tengo que dejarte.	WHW-ES-Pr/Sonidos-ES/Sonidos-ES.eaf
Sobreescrito en pantalla. ZOE. LA PRÓXIMA.	WHW-ES-Pr/Sonidos-ES/Sonidos-ES.eaf
Sobreescrito en pantalla. Qué pasa mientras....	WHW-ES-Pr/Sonidos-ES/Sonidos-ES.eaf
Por la mañana, en una playa, una pareja pasea con su perro, mientras un hombre que corre se cruza con ellos. El perro, un gran danés, se entretiene en unos hierbajos y olfatea la zona. Su dueño, al darse cuenta de que se queda atrás, lo llama. El perro obedece y se va con ellos.	WHW-ES-Pr/Tragora-ES/Tragora-ES.eaf
0Sobreimpreso en pantalla…	WHW-ES-Pr/Tragora-ES/Tragora-ES.eaf
Un deportivo blanco de alta gama se detiene junto a la avenida de la playa. En su interior, un hombre de unos 50 años habla por el móvil y sale del vehículo.	WHW-ES-Pr/Tragora-ES/Tragora-ES.eaf
Enfadado, cuelga y suspira. El hombre, alto y apuesto, con barba, lleva traje y corbata. Introduce la mano en el bolsillo izquierdo de la chaqueta, saca unas gafas de sol de estilo aviador y se las pone. Sobreimpreso en pantalla: James, el empresario. Poco después, pasea con el móvil en la oreja y un bolso de rayas en el hombro.	WHW-ES-Pr/Tragora-ES/Tragora-ES.eaf
Minutos más tarde, algo cansado, se tumba en la playa sobre una toalla y toma el sol tranquilamente.	WHW-ES-Pr/Tragora-ES/Tragora-ES.eaf
James se lleva las manos a la cara y se restriega un poco los ojos. A continuación, deja caer las manos sobre la arena y juguetea con ella cogiendo un puñado y soltándolo.	WHW-ES-Pr/Tragora-ES/Tragora-ES.eaf
Se incorpora.	WHW-ES-Pr/Tragora-ES/Tragora-ES.eaf
Mira a su alrededor.	WHW-ES-Pr/Tragora-ES/Tragora-ES.eaf
Cuelga el teléfono y lo lanza a un lado. Extrañado por el sonido, se levanta y empieza a caminar junto a la orilla del mar. Lleva un bañador de tipo bóxer negro.	WHW-ES-Pr/Tragora-ES/Tragora-ES.eaf
El ruido le llama la atención e intenta averiguar de dónde procede. Camina alrededor y centra la mirada en varios puntos distintos.	WHW-ES-Pr/Tragora-ES/Tragora-ES.eaf
Da unos pequeños pasos hacia atrás y de repente…	WHW-ES-Pr/Tragora-ES/Tragora-ES.eaf
De nuevo, da unos pasos más alrededor mientras intenta descubrir de dónde proviene el sonido. A continuación, sigue caminando y, ahora, fija su mirada en un punto superior.	WHW-ES-Pr/Tragora-ES/Tragora-ES.eaf
Se acerca al lugar donde había dejado la ropa y se pone la camisa. Mientras se va vistiendo, continúa mirando un punto en lo alto. Se agacha para recoger el resto de sus cosas y se va.	WHW-ES-Pr/Tragora-ES/Tragora-ES.eaf
Poco más tarde, vestido ya con el traje pero sin corbata, sigue caminando absorto en el ruido. Abandona la playa, llega a la avenida y sube por una montaña siguiendo un camino. Decisivo y con cuidado, consigue subir el empinado sendero.	WHW-ES-Pr/Tragora-ES/Tragora-ES.eaf
Mientras tanto, sentado en el banco de un parque, un hombre de unos 60 años sostiene un café en un vaso de plástico cerrado.	WHW-ES-Pr/Tragora-ES/Tragora-ES.eaf
 Tiene barba y el pelo largo, con un aspecto desaliñado. Pensativo, niega con la cabeza.	WHW-ES-Pr/Tragora-ES/Tragora-ES.eaf
Indeciso, hace un círculo con el dedo en la tapa del café y la retira. Cuando se lo lleva a la boca, se detiene y mira el contenido fijamente. Segundos más tarde, toma un sorbo y lo saborea.	WHW-ES-Pr/Tragora-ES/Tragora-ES.eaf
Sobreimpreso en pantalla: Rick, el jubilado. Va vestido con una camiseta de tirantes, un pantalón vaquero y unas zapatillas deportivas. Sentado a la sombra de unos árboles, toma el café al tiempo que mueve incesantemente la pierda derecha. A continuación, lo deposita en un banco que tiene al lado. Nervioso, da unas palmadas, se frota las manos e, inclinándose, saca el teléfono móvil que tiene en el bolsillo trasero. Levanta la funda y empieza a mirar entre su lista de contactos. Al llegar al nombre de Craig Anderson, pulsa el botón de llamada y se lleva el móvil a la oreja. Con semblante serio, espera respuesta.	WHW-ES-Pr/Tragora-ES/Tragora-ES.eaf
Extrañado por el ruido, mira a su alrededor.	WHW-ES-Pr/Tragora-ES/Tragora-ES.eaf
El ruido le llama la atención.	WHW-ES-Pr/Tragora-ES/Tragora-ES.eaf
Rick se levanta del banco, cuelga y vuelve a poner el móvil en el bolsillo. Sorprendido por el sonido, empieza a caminar mirando de un lado para otro. Deja olvidado el café. Mientras tanto, una chica pelirroja de unos 20 años estudia en su casa. Parece agobiada.	WHW-ES-Pr/Tragora-ES/Tragora-ES.eaf
Sobreimpreso en pantalla: Jess, la estudiante.	WHW-ES-Pr/Tragora-ES/Tragora-ES.eaf
Jess busca el móvil en el escritorio,	WHW-ES-Pr/Tragora-ES/Tragora-ES.eaf
hasta que lo encuentra debajo de unos apuntes.	WHW-ES-Pr/Tragora-ES/Tragora-ES.eaf
Muy extrañada, cuelga la llamada y mira alrededor de su habitación intentando averiguar de dónde procede el sonido. Cuando se dispone a mirar sus apuntes…	WHW-ES-Pr/Tragora-ES/Tragora-ES.eaf
De repente, se levanta.	WHW-ES-Pr/Tragora-ES/Tragora-ES.eaf
Jess sale de su casa y comienza a caminar atraída por el sonido. Lleva una cazadora y un pañuelo alrededor del cuello. Con decisión, empieza a subir por una montaña. De repente, se detiene, mira a un lado y a otro e identifica finalmente desde dónde viene el sonido. A continuación, avanza rápidamente hacia este.	WHW-ES-Pr/Tragora-ES/Tragora-ES.eaf
Jess ha llegado a una explanada donde también se encuentran James y Rick. Estos, mediante señas, se preguntan si también escuchan el mismo sonido.	WHW-ES-Pr/Tragora-ES/Tragora-ES.eaf
James, Rick y Jess, sorprendidos por la voz que escuchan, miran en todas direcciones.	WHW-ES-Pr/Tragora-ES/Tragora-ES.eaf
Rick se emociona.	WHW-ES-Pr/Tragora-ES/Tragora-ES.eaf
Rick se ríe tímidamente.	WHW-ES-Pr/Tragora-ES/Tragora-ES.eaf
Los tres se cruzan las miradas. Rick, dubitativo, niega con la cabeza, al igual que Jess.	WHW-ES-Pr/Tragora-ES/Tragora-ES.eaf
Rick mira al cielo, con los brazos abiertos.	WHW-ES-Pr/Tragora-ES/Tragora-ES.eaf
James empieza a caminar y, tranquilo, mete las manos en los bolsillos. Rick le sigue. Jess se ha quedado pensativa, pero…	WHW-ES-Pr/Tragora-ES/Tragora-ES.eaf
Jess da unas pocas zancadas y los alcanza enseguida. Ellos miran atrás y, cariñosamente, James le pone la mano por encima y Rick hace lo mismo. Poco a poco se van alejando de la explanada y vuelven al mismo lugar por el que subieron. En otro lugar, una mujer habla por teléfono mientras tiende la ropa.	WHW-ES-Pr/Tragora-ES/Tragora-ES.eaf
Sorprendida, mira a su alrededor.	WHW-ES-Pr/Tragora-ES/Tragora-ES.eaf
Cuelga el teléfono, extrañada. Sobreimpreso en pantalla: Zoé, la próxima. Fundido en negro. Sobre un fondo blanco con letras negras: "Qué pasa mientras…"	WHW-ES-Pr/Tragora-ES/Tragora-ES.eaf
